'unter den linden'	'ウンテル・デン・リンデン'
'san pietro'	'サンピエトロ'
'da vinci'	'ダ・ヴィンチ'
'sanmartin'	'サンマルチン'
'dalai lama'	'ダライ・ラマ'
'ability'	'アビリチー'
'absolutism'	'アプソリュチズム'
'abyssinia'	'アビシニア'
'acacia'	'アカシヤ'
'academia'	'アカデミア'
'academic'	'アカデミック'
'academy'	'アカデミー'
'accent'	'アクセント,アクサン'
'acetylene'	'アセチリン'
'achilles'	'アキレス'
'actor'	'アクター'
'adams'	'アダムス'
'aden'	'アデン'
'admiral'	'アドミラル'
'aesop'	'イソップ'
'aesthetic'	'エステ'
'afghan'	'アフガン'
'afghanistan'	'アフガニスタン'
'agrippa'	'アグリッパ'
'aine'	'エネ'
'aino'	'アイノ'
'ainu'	'アイヌ,アイノ'
'aiskhylos'	'イスキラス'
'alai'	'アライ'
'alambique'	'ランビキ'
'alaska'	'アラスカ'
'albrecht'	'アルブレヒト'
'album'	'アルバム'
'alcala'	'アルカラ'
'alcock'	'オルコック'
'alcott'	'オルコット'
'alessandro'	'アレサンドロ'
'alexandria'	'アレキサンドリア,アレキサンドリヤ'
'alfred'	'アルフレツド,アルフレッド'
'alhambra'	'アルハンブラ'
'alkali'	'アルカリー,アルカリ'
'alkaloid'	'アルカロイド'
'all right'	'オーライ'
'alpen'	'アルペン'
'alphabet'	'アルファベット'
'alps'	'アルプス'
'alsace'	'アルサス'
'alte'	'アルト'
'amazon'	'アマゾン'
'ambitious'	'アンビシャス'
'amdo'	'アムド'
'amen'	'アーメン'
'ammonia'	'アンモニア'
'amobe'	'アメーバ'
'amor'	'アモール'
'ampere'	'アンペア'
'amplifier'	'アンプ'
'amsterdam'	'アムステルダム'
'ana'	'アナ'
'anarchist'	'アナーキスト'
'andaman'	'アンダマン'
'andersen'	'アンデルゼン,アンデルセン'
'anderson'	'アンダーソン'
'andes'	'アンデス'
'andrew'	'アンドリュー'
'andromeda'	'アンドロメダ'
'anemone'	'アネモネ'
'aneroid'	'アネロイド'
'anglo'	'アングロ'
'anglo-saxon'	'アングロサクソン'
'ani'	'アニ'
'animism'	'アミニズム'
'anne'	'アン,アンヌ'
'antenna'	'アンテナ'
'anti'	'アンチ'
'antigone'	'アンチゴーネ'
'antimon'	'アンチモニー'
'antipyrine'	'アンチピリン'
'antwerp'	'アントワープ'
'apple'	'アップル'
'apron'	'エプロン'
'aq-su'	'アクス'
'arab'	'アラブ'
'arabian'	'アラビアン'
'ararat'	'アララ'
'arbos'	'アルボース,アルボオス'
'arbuda'	'アバタ'
'arc'	'アーク'
'arch'	'アーチ'
'arden'	'アーデン'
'argentina'	'アルゼンチン'
'aristotle'	'アリストートル,アリストート'
'arkhimedes'	'アーキミジス'
'armenia'	'アルメニア'
'armor'	'アーマー'
'armstrong'	'アームストロング'
'arnold'	'アーノルド'
'arrangement'	'アレンジメント'
'arrow'	'アロー'
'arthur'	'アーサー'
'artificial'	'アーティフィシャル'
'artist'	'アーチスト'
'arya'	'アリアン,アーリヤ'
'assam'	'アッサム'
'assembly'	'アッセンブリー'
'assyria'	'アッシリア,アッシリヤ,アツシリヤ'
'ataraxia'	'アタラクシア'
'atelier'	'アトリエ'
'atmosphere'	'アトモスフェア'
'atom'	'アトム'
'atonie'	'アトニー'
'attila'	'アッティラ'
'auckland'	'オークランド'
'augusto'	'アウグスト'
'augustus'	'アウグスツス'
'aurora'	'オーロラ'
'austen'	'オースチン'
'australia'	'オーストラリア,アウストラリヤ,オーストラリヤ'
'auto'	'オート'
'avalanche'	'アバランチ'
'avant'	'アヴァン'
'babel'	'ベベル,バベル'
'babylon'	'バビロン'
'bachelor'	'バチエラー,バチェラー'
'back'	'バツク'
'bacon'	'ベーコン'
'bacteria'	'バクテリア,バクテリヤ'
'bag'	'バツグ'
'bagdad'	'バグダッド'
'bahn'	'バーン'
'bain'	'ベイン'
'baker'	'ベーカー'
'balcony'	'バルコン,バルコニー'
'bald'	'ボールド'
'balfour'	'バルフォア'
'balkan'	'バルカン'
'baltic'	'バルチック,バルチツク'
'balz'	'ベルツ'
'banana'	'バナナ'
'bang'	'バン'
'banyan'	'バンヤン'
'baptisma'	'バプテスマ'
'bar'	'バー'
'bark'	'バーク'
'barling'	'バーリング'
'barn'	'バーン'
'barometer'	'バロメートル'
'baron'	'バロン'
'barret'	'バレツト'
'barth'	'バース'
'baseball'	'ベースボール'
'basel'	'バーゼル'
'bass'	'ベース'
'bass'	'バツソ,バス'
'bastiat'	'バスチヤ'
'bat'	'バツト,バット'
'batiste'	'バチスト'
'batter'	'バッター'
'bayern'	'バイエルン'
'bazillus'	'バチルス'
'beale'	'ビール'
'beautiful'	'ビユーチフル'
'beck'	'ベック'
'beecher'	'ビーチャー'
'beethoven'	'ベートーベン'
'bell'	'ベル'
'belly'	'ベリー'
'belmont'	'ベルモント'
'belt'	'ベルト'
'benares'	'ベナレス'
'bench'	'ベンチ'
'bengal'	'ベンガル,ベンゴール'
'bengala'	'ベンガラ'
'benjamin'	'ベンジャミン'
'benn'	'ベン'
'bent'	'ベント'
'bentham'	'ベンサム,ベンダム'
'berber'	'ベルベル'
'bergen'	'ベルゲン'
'bergson'	'ベルグソン'
'berkeley'	'バークレー'
'berkshire'	'バークシャー'
'bern'	'ベルン'
'best'	'ベスト'
'betta'	'ベタ'
'beuve'	'ブーヴ'
'bhutan'	'ブータン'
'bible'	'バイブル'
'bichon'	'ビション'
'big'	'ビッグ'
'bird'	'バード'
'birmingham'	'バーミンガム'
'biscay'	'ビスケー'
'biscuit'	'ビスケツト,ビスケット'
'bjorn'	'ビョルン'
'blanket'	'ゲツト,ケット'
'blond'	'ブロンド'
'blood'	'ブラッド'
'blotch'	'ブロッチ'
'blucher'	'ブリユツヘル'
'bluff'	'ブラフ'
'boa'	'ボア'
'board'	'ボード,ボールド'
'boat'	'ボート'
'bock'	'ボック'
'böcklin'	'ベクリン'
'boer'	'ボーア'
'bohemia'	'ボヘミア'
'bohmen'	'ベーメン'
'bolivia'	'ボリビア'
'bombay'	'ボンベイ'
'bonaparte'	'ボナパルト'
'bonbon'	'ボンボン'
'bonn'	'ボン'
'boom'	'ブーム'
'bordeaux'	'ボルドウ,ボルドー'
'borgmann'	'ボルクマン'
'borneo'	'ボルネオ'
'bosporus'	'ボスポラス'
'boss'	'ボス'
'boston'	'ボストン'
'both'	'ボース'
'bouquet'	'ブーケ'
'bourbon'	'ブルボン'
'box'	'ボックス'
'bra'	'ブラ'
'bradford'	'ブラッドフォード'
'brahmaputra'	'ブラマプトラ'
'brake'	'ブレーキ'
'braking'	'ブレイキング'
'brandenburg'	'ブランデンブルゲル'
'brandpunt'	'ピント'
'brandt'	'ブラント'
'brandy'	'ブランディ,ブランデー,ブランデイ'
'bravo'	'ブラボー,ブラヴォー'
'brazil'	'ブラジル'
'bright'	'ブライト'
'brin'	'ブリン'
'brindisi'	'ブリンヂイシイ'
'briton'	'ブリトン'
'britten'	'ブリテン'
'bronze'	'ブロンズ'
'brown'	'ブラウン'
'browning'	'ブラウニング'
'brunn'	'ブルノ'
'buck'	'バック'
'bucket'	'バケツ'
'budapest'	'ブタペスト'
'buerger'	'バージャー'
'buff'	'バフ'
'buffer'	'バッファ'
'buffon'	'ブッフォン'
'bukarest'	'ブカレスト'
'bulldog'	'ブルドッグ'
'bulwark'	'ブルワーク'
'bungalow'	'バンガロー'
'buns'	'バンズ'
'buoy'	'ブイ'
'burbank'	'バーバンク'
'bureau'	'ビューロー'
'burg'	'ブルク'
'burma'	'ビルマ'
'burns'	'バーンス'
'burr'	'バリ'
'business'	'ビジネス'
'bust'	'バスト'
'butter'	'バタ,バター'
'byrd'	'バード'
'byron'	'バイロン'
'byzantine'	'ビザンチン'
'cab'	'キャブ'
'cabbage'	'キヤベツ,キャベツ'
'cabin'	'キャビン'
'cachon'	'カション'
'cairo'	'カイロ'
'cake'	'ケーク'
'calcao'	'カルサン'
'calcutta'	'カルカツタ,カルカッタ'
'calici'	'カリシ'
'calico'	'キヤラコ,キャリコ,キャラコ'
'california'	'カリフォルニヤ,カリフォルニア,カリホルニヤ,カルフォルニア'
'caliph'	'カリフ'
'calla'	'カラー'
'calvin'	'カルバン'
'cam'	'カム'
'cambridge'	'ケンブリッジ,ケンブリジ,ケムブリッヂ'
'camellia'	'カメリヤ'
'camera'	'カメラ'
'campan'	'カムペン'
'canal'	'カナル'
'canard'	'カナール'
'canaria'	'カナリヤ,カナリア'
'cancan'	'カンカン'
'cannon'	'カノン'
'canterbury'	'カンタベリー'
'canvas'	'カンバス,カンヴァス'
'cape'	'ケープ'
'caramelo'	'カルメル'
'carat'	'カラット'
'carbonate'	'カルボナァート'
'card'	'カード'
'carlyle'	'カアライル,カーライル,カライル'
'carnet'	'カルネ'
'carol'	'カロル'
'carpenter'	'カーペンター'
'carr'	'カー'
'carroll'	'キャロル'
'carter'	'カーター'
'carthago'	'カルタゴ'
'casa'	'カサ'
'case'	'ケース'
'cashmere'	'カシミヤ'
'casino'	'カジノ'
'castanet'	'カスタネット,カスタネツト'
'caste'	'カースト'
'castella'	'カステラ'
'castor'	'カストル'
'catalog'	'カタログ'
'catapult'	'カタパルト'
'cater'	'ケーター'
'catilina'	'カテリーナ'
'cato'	'カトー'
'caucasus'	'コーカサス'
'cause'	'コーズ'
'cavour'	'カブール'
'cedric'	'セドリック'
'cello'	'セロ'
'celluloid'	'セルロイド'
'celt'	'ケルト'
'celtic'	'セルチック'
'cement'	'セメント'
'cesar'	'セサル'
'cesium'	'ケイシオム'
'chain'	'チエーン,チェン,チエイン'
'chair'	'チェア'
'chalk'	'チヨーク,チョーク'
'chamber'	'チャンバ'
'champagne'	'シャンペン,シャンパン,シヤンパン'
'champion'	'チャンピオン'
'champs-elysees'	'シャンゼリゼー'
'chandelier'	'シャンデリヤ'
'chandler'	'チャンドラ'
'chapeau'	'シャッポ'
'chapel'	'チャペル'
'char'	'シャール'
'charamela'	'チャルメラ'
'charles'	'シャルル,チャールズ,チャールス'
'charm'	'チャーム,チヤーム'
'chastity'	'チヤスチチイ'
'cheap'	'チープ'
'check'	'チェック'
'cheer'	'チア'
'cheese'	'チーズ'
'chert'	'チャート'
'chez'	'シェ'
'chicago'	'シカゴ'
'chief'	'チーフ'
'chile'	'チリ'
'chloroform'	'クロロホルム,コロロホルム'
'chocolate'	'チョコレート,チョコ,チヨコレート'
'choir'	'クワイア'
'chop'	'チャップ'
'chou'	'チュー'
'christian'	'クリスチャン,クリスチァン,クリスチヤン'
'christmas'	'クリスマス'
'chrome'	'クローム'
'chunk'	'チャンク'
'churchill'	'チャーチル,チヤーチル'
'cicli'	'チクリ'
'cider'	'サイダ,サイダー,サイダア'
'cigar'	'シガー'
'cigarette'	'シガレット,シガレツト'
'cinema'	'シネマ'
'cinematographe'	'シネマトグラフ'
'circe'	'キルケ'
'circle'	'サークル'
'citron'	'シトロン'
'civil'	'シビル'
'claimer'	'クレーマー'
'clan'	'クラン'
'clapham'	'クラパム'
'clara'	'クララ'
'clarinet'	'クラリネッ卜,クラリオネット'
'clark'	'クラーク'
'clary'	'クラリ'
'class'	'クラス,カラッス'
'classic'	'クラシツク,クラッシック'
'classicism'	'クラシシズム'
'clean'	'クリン'
'clear'	'クリア'
'cleveland'	'クリーブランド,クリーヴランド'
'clos'	'クロー,クロ'
'clover'	'クローバ'
'coal'	'コル'
'coat'	'コート,コオト,コーツ'
'cobalt'	'コバルト'
'cobden'	'コブデン'
'cobra'	'コブラ'
'cocoa'	'ココア'
'coerver'	'クーバー'
'cognac'	'コニャック'
'coil'	'コイル'
'coliseum'	'コロッセウム'
'colombia'	'コロンビヤ'
'colombo'	'コロンボ'
'colony'	'コロニー'
'colorado'	'コロラド'
'columbus'	'コロンブス,コロンバス'
'column'	'カラム'
'com'	'コム'
'coma'	'コマ'
'comedy'	'コメディー'
'comma'	'カンマ,コンマ'
'commander'	'コンマンダー'
'common'	'コムモン,コンモン'
'communist'	'コムニスト'
'companion'	'コンパニオン'
'compensation'	'コンペンセイシヨン'
'composition'	'コンポジション'
'conan'	'コナン'
'concorde'	'コンコルド'
'concrete'	'コンクリート'
'condor'	'コンドル'
'conference'	'コンファレンス,コンフェレンス'
'confidence'	'コンフィデンス'
'conformation'	'コンフォメーション'
'congo'	'コンゴー,コンゴ'
'congregationalist'	'コンクレゲーショナリスツ'
'conservatism'	'コンセルワチズム'
'consistent'	'コンシステント'
'contrast'	'コントラスト'
'cook'	'クツク,クック'
'cooper'	'クーパー'
'copenhagen'	'コペンハーゲン'
'copernicus'	'コペルニクス'
'cord'	'コード'
'cordova'	'コルドヴァ'
'corned beef'	'コーンビーフ'
'corsica'	'コルシカ'
'cortes'	'コルテス'
'cosmetic'	'コスメチック'
'cosmo'	'コスモ'
'cosmopolitan'	'コスモポリタン'
'cosmos'	'コスモス'
'cossack'	'コサック'
'cotton'	'カタン'
'coup d''etat'	'クーデター'
'cover'	'カバー,カヴァー'
'cream'	'クリーム,クリイム'
'creosote'	'クレオソート,ケレオソート'
'creta'	'クレタ'
'crimea'	'クリミヤ,クリミア'
'crisis'	'クライシス'
'cromwell'	'クロムウェル,クロムウエル,コロンウェル'
'croup'	'クルップ'
'crow'	'クロウ'
'crusoe'	'クルーソー'
'cub'	'カブ'
'cue'	'キュー'
'cuff'	'カフス,カフ'
'cult'	'カルト'
'cupid'	'キューピッド'
'curacao'	'キユラソオ'
'curl'	'カール'
'curry'	'カレー'
'curve'	'カーブ'
'cushion'	'クッション'
'cut'	'カツト'
'cutlet'	'カツ,カツレツ'
'cutter'	'カツター'
'cyan'	'シヤン'
'cynical'	'シニカル'
'cyprus'	'キプロス'
'da/de'	'ダ'
'dahlia'	'ダリヤ,ダーリア,ダアリア'
'daimon'	'ダイモン'
'dam'	'ダム'
'damask'	'ダマスク'
'dan'	'ダン'
'dance'	'ダンス'
'dancing'	'ダンシング'
'dane'	'デーン'
'danube'	'ダニューブ'
'dark'	'ダーク'
'darlington'	'ダーリントン'
'darth'	'ダース'
'darwin'	'ダーウィン,ダーヰン,ダルウヰン,ダルヰン'
'darwinism'	'ダルウヰニズム'
'deaf'	'デフ'
'deca'	'デカ'
'decadant'	'デカダン,デカタン'
'decadence'	'デカダンス'
'decae'	'ドカ'
'dee'	'ディー'
'delhi'	'デリー'
'delicacy'	'デリカシー'
'demagog'	'デマゴーグ'
'demi'	'ドミ'
'demo'	'デモ'
'democracy'	'デモクラシー'
'democratic'	'デモクラチツク,デモクラシック'
'denomination'	'デノミネーション'
'descartes'	'デカルト'
'desert'	'デザート'
'desk'	'デスク'
'dessin'	'デッサン'
'deutschen'	'ドイ'
'diagram'	'ダイヤ'
'diamond'	'ダイヤモンド,ダイアモンド,ギヤマン'
'diene'	'ジエン'
'dilemma'	'ディレンマ,ジレンマ'
'dilettante'	'ディレッタント,ジレッタント'
'dimension'	'ダイメンシヨン'
'dionysius'	'ディオニシウス'
'diphtheria'	'ジフテリア'
'distoma'	'ヂストマ'
'dobrolyubov'	'ドブロリューボフ'
'dock'	'ドック'
'doctor'	'ドクトル'
'doeff'	'ヅーフ'
'doek'	'ズック,ズツク'
'dominica'	'ドミニカ'
'donna'	'ドンナ'
'door'	'ドア'
'dostoevskii'	'ドストイェフスキー,ドストエフスキー'
'double'	'ダブル'
'dough'	'ドウ'
'doula'	'ドーラ'
'dow'	'ダウ'
'doyle'	'ドイル'
'dozen'	'ダース'
'draco'	'ドラコ'
'draft'	'ドラ'
'dram'	'ダラム'
'drama'	'ドラマ'
'dramatical'	'ドラマチカル'
'dramatist'	'ドラマチスト'
'dreadnought'	'ドレッドノート'
'dreamer'	'ドリーマー'
'dresden'	'ドレスデン'
'dressing'	'ドレッシング'
'droschke'	'ドロシュケ'
'drum'	'ドラム'
'duke'	'デューク'
'dull'	'ダル'
'dumdum'	'ダムダム'
'durer'	'ドュウレル'
'durian'	'ドリアン'
'dyck'	'ダイク'
'dynamite'	'ダイナマイト'
'dynamo'	'ダイナモ'
'ear'	'イヤ'
'earl'	'アアル'
'east'	'イースト'
'easter'	'イースター'
'easy'	'イージー'
'easygoing'	'イージーゴーイング'
'ebonite'	'エボナイト'
'eccentric'	'エクセントリック'
'economy'	'エコノミー'
'eden'	'エデン,ヱデン'
'edinburgh'	'エディンバラ,エジンバラ'
'edison'	'エジソン'
'edmond'	'エドモンド'
'edward'	'エドワード,エドワルド'
'egalite'	'エガリテ'
'egg'	'エッグス'
'egoist'	'エゴイスト'
'egoistic'	'エゴイスチック'
'el'	'エル'
'elbe'	'エルベ'
'elea'	'エレア'
'electron'	'エレクトロン'
'element'	'エレメント'
'eleonora'	'エレオノラ'
'elevator'	'エレヴェーター'
'elizabeth'	'エリザベス'
'ellis'	'エリス'
'elm'	'エルム'
'elocution'	'エロキューション'
'emerald'	'エメラルド'
'encyclopaedia'	'エンサイクロペヂア'
'energy'	'エナージー,エネルギー'
'engage'	'エンゲージ'
'engine'	'エンジン'
'ennui'	'アンニュイ'
'enya'	'エンヤ'
'epaulette'	'エポレット'
'epicurean'	'エピキュリアン'
'epiktetos'	'エピクテタス'
'epoch'	'エポック'
'erotic'	'エロチック'
'escape'	'エスケープ'
'eskimo'	'エスキモー,エスキモ'
'esperanto'	'エスペラント'
'esquisse'	'エスキス'
'etching'	'エッチング'
'ether'	'エーテル'
'etna'	'エトナ'
'eucalyptus'	'ユーカリ'
'euripides'	'オイリピデス'
'euston'	'ユーストン'
'exlibris'	'エツキスリプリス'
'extract'	'エキス'
'eze'	'エズ'
'fact'	'ファクト'
'family'	'ファミリー'
'farrow'	'ファロー'
'faust'	'ファウスト,フアウスト'
'feather'	'フェザー'
'fechner'	'フェヒナー'
'fell'	'フェル'
'felt'	'フエルト'
'feminine'	'フェミニン'
'fetch'	'フェッチ'
'fichte'	'フィヒテ,フィフテ'
'fielding'	'フィールディング'
'file'	'ファイル'
'filled'	'フィルド'
'film'	'フィルム'
'fin'	'フィン'
'fin de siecle'	'フアンドシエクル'
'finn'	'フィン'
'firenze'	'フィレンチェ'
'fisk'	'フィスク'
'fit'	'フィッツ'
'flail'	'フレール'
'flan'	'フラン'
'flandre'	'フランドル'
'flannel'	'フランネル,ネル'
'flavell'	'フレーベル'
'flora'	'フロラ'
'florence'	'フロレンス'
'flow'	'フロ'
'fluke'	'フロック'
'flute'	'フルウト'
'fly'	'フライ'
'foil'	'ホイル'
'folio'	'フォリオ'
'folklore'	'フォクロア'
'foot'	'フット'
'football'	'フートボール'
'force'	'フォース'
'formalin'	'フォルマリン'
'formula'	'フォーミュラー'
'foster'	'フオスター,フォスター'
'franc'	'フラン'
'francisco'	'フランシスコ'
'frank'	'フランク'
'franken'	'フランケン'
'frankfurt am main'	'フランクフルト'
'franklin'	'フランクリン'
'franz'	'フランツ'
'franziska'	'フランチェスカ'
'frasco'	'フラスコ'
'frau'	'フラウ'
'fraulein'	'フロイライン'
'frederick'	'フレデリック,フレデリツク'
'freiburg'	'フライブルグ'
'freytag'	'フライタハ'
'friday'	'フライデー'
'friedland'	'フリードランド'
'friedrich'	'フリードリッヒ'
'frock'	'フロツク'
'frye'	'フライ'
'fugo'	'フーゴー'
'full'	'フル'
'function'	'ファンクション'
'fur'	'ファー'
'gaia'	'ガイア'
'gaius'	'ガイウス'
'gal'	'ギャル,ガル'
'gala'	'ガラ'
'galatia'	'ガラテヤ'
'galilei'	'ガリレイ'
'galileo'	'ガリレオ'
'gall'	'ガル'
'galle'	'ガレ'
'galley'	'ゲラ'
'galton'	'ゴルトン'
'game'	'ゲー,ゲーム'
'ganges'	'ガンジス'
'gasoline'	'ガソリン'
'gasse'	'ガッセ'
'gate'	'ゲート'
'gath'	'ガト'
'gaze'	'ガーゼ'
'gel'	'ゲル'
'gene'	'ジーン'
'general'	'ゼネラル'
'genova'	'ジェノア,ゼノア'
'gentleman'	'ゼントルメン'
'ghali'	'ガリ'
'gibbon'	'ギボン'
'gibraltar'	'ジブラルタル'
'gil'	'ギル'
'gilbert'	'ギルバート'
'gillie'	'ギリー'
'gini'	'ジニ'
'giotto'	'ジョット'
'glasgow'	'グラスゴー'
'glass'	'グラス'
'glee'	'グリー'
'glow'	'グロー'
'glut'	'グラット'
'gnu'	'ヌー'
'goal'	'ゴール'
'gobi'	'ゴビ'
'god'	'ゴッド'
'gogol'	'ゴーゴリ'
'gold'	'ゴールド'
'goldsmith'	'ゴールドスミス'
'golf'	'ゴルフ'
'golgotha'	'ゴルゴタ'
'goncourt'	'ゴンクウル'
'gondola'	'ゴンドラ'
'gordon'	'ゴードン'
'gorilla'	'ゴリラ'
'gorky'	'ゴルキー'
'gothic'	'ゴチック,ゴシック'
'gottfried'	'ゴットフリート'
'gottingen'	'ゲッチンゲン'
'gounod'	'グノー'
'gourde'	'グールド'
'gown'	'ガウン'
'graham'	'グラハム'
'gram'	'グラム'
'granada'	'グラナダ'
'grant'	'グラント'
'graphic'	'グラフィック'
'grease'	'グリース'
'great'	'グレイト,グレート'
'green'	'グリン'
'greenland'	'グリーンランド'
'greuze'	'グルーズ'
'grey'	'グレー,グレイ'
'gris'	'グリ'
'ground'	'グラウンド,グランド'
'grounder'	'ゴロ'
'group'	'グループ,グルッペ'
'guattari'	'ガタリ'
'guide'	'ガイド'
'guimet'	'ギメ'
'guiro'	'ギロ'
'guizot'	'ギゾー'
'gun'	'ガン'
'gurkha'	'ゴルカ'
'guru'	'グル'
'gustav'	'グスタアフ'
'guy'	'ギイ'
'gypsy'	'ジプシー'
'hack'	'ハック'
'haeckel'	'ヘッケル'
'haim'	'ハイム'
'halle'	'ハレ'
'hallelujah'	'ハレルヤ'
'halley'	'ハレー'
'halt'	'ハルト'
'hamburg'	'ハンブルグ'
'hammock'	'ハンモック'
'hampden'	'ハンプデン'
'han'	'ハン'
'handel'	'ヘンデル'
'handicap'	'ハンデキャップ'
'handle'	'ハンドル'
'hannibal'	'ハンニバル'
'harmonia'	'ハルモニア'
'harmonica'	'ハーモニカ,ハモニカ'
'harmony'	'ハーモニー'
'harris'	'ハリス'
'harrison'	'ハリソン'
'harte'	'ハート'
'harvard'	'ハーバード'
'harvey'	'ハーベー'
'hat'	'ハット,ハツト'
'hatta'	'ハッタ'
'hauptmann'	'ハウプトマン'
'hawthorne'	'ホーソーン'
'heavy'	'ヘビー'
'hebraism'	'ヘブライズム'
'hector'	'ヘクター'
'hedin'	'ヘディン'
'hedonism'	'ヘドニズム'
'hegel'	'ヘーゲル'
'heine'	'ハイネ'
'helene'	'ヘレーネ'
'heliotrope'	'ヘリオトロオブ,ヘリオトロープ'
'helium'	'ヘリウム'
'hell'	'ヘル'
'hellenism'	'ヘレニズム'
'hello'	'ハロ'
'helmet'	'ヘルメット'
'help'	'ヘルプ'
'hepburn'	'ヘボン'
'hera'	'ヘラ'
'herakles'	'ヘラクレス,ヘルクレス,ハーキュリス'
'herbart'	'ヘルバルト'
'herbert'	'ヘルベルト'
'hermann'	'ヘルマン'
'hermes'	'ヘルメス'
'hesiodos'	'ヘシオドス'
'hey'	'ヘイ'
'hi'	'ハイ'
'him'	'ヒム'
'himalaya'	'ヒマラヤ'
'hint'	'ヒント'
'hobbes'	'ホッブス'
'hobson'	'ホブソン'
'hoffmann'	'ホフマン'
'holi'	'ホリー,ホーリー'
'holstein'	'ホルスタイン'
'homer'	'ホーマー'
'homeros'	'ホメロス,ホメーロス'
'honu'	'ホヌ'
'hood'	'フッド'
'hoos'	'ホース'
'horizon'	'ホライズン'
'hoss'	'ホス'
'hot'	'ホット,ホツト'
'hotel'	'ホテル'
'hound'	'ハウンド'
'house'	'ホイス'
'huey'	'ヒューイ'
'huguenot'	'ユグノー'
'humanity'	'ヒユーマニチー,ヒューマニチー'
'humboldt'	'フムボルト'
'hume'	'ヒューム'
'humor'	'ユーモア'
'humorist'	'ユーモリスト'
'hundred'	'ハンドレッド'
'hungarian'	'ハンガリア'
'hunt'	'ハント'
'hurrah'	'フラー'
'husband'	'ハズバンド'
'hyacinth'	'ヒヤシンス,ヒアシンス'
'hyde'	'ハイド'
'hysteric'	'ヒステリック'
'hysterical'	'ヒステリカル'
'hysterie'	'ヒステリー,ヒステリイ'
'iceland'	'アイスランド'
'ideal'	'アイデアル'
'idealism'	'アイデアリズム'
'idealist'	'アイデアリスト'
'iesous'	'イエス,イヱス'
'ikra'	'イクラ'
'illich'	'イリイッチ'
'illinois'	'イリノイ'
'illumination'	'イルミネーション'
'image'	'イメージ'
'income'	'インカム'
'individual'	'インジヴィジュエル'
'indus'	'インダス'
'influenza'	'インフルエンザ'
'initial'	'イニシャル'
'inkstand'	'インクスタンド'
'innocent'	'イノセント'
'inspiration'	'インスピレーシヨン,インスピレーション'
'iodate'	'ヨテェート'
'ion'	'イオン'
'iran'	'イラン'
'iris'	'アイリス,イリス'
'ironical'	'アイロニカル'
'irving'	'アービング'
'isaac'	'アイザック'
'isaiah'	'イザヤ'
'ism'	'イズム'
'iso'	'イソ'
'israel'	'イスラエル,イスラヱル'
'italian'	'イタリアン'
'ivan'	'イヴァン,イバン'
'ives'	'アイヴス'
'ja'	'ヤー'
'jack'	'ジャック'
'jacket'	'ジャケツ,ジャケット'
'jackson'	'ジャクソン'
'jai'	'ジャイ'
'jakob'	'ヤコブ,ヤコフ'
'jam'	'ジャム'
'jamaica'	'ジャマイカ'
'jambo'	'ジャンボ'
'james'	'ジェームス,ゼームス'
'jan'	'ヤン'
'janes'	'ジェーン'
'japan'	'ジャパン'
'jaque'	'チヨツキ'
'jay'	'ゼー'
'jehovah'	'エホバ,ヱホバ'
'jena'	'イェーナ'
'jerry'	'ジェリー,ジェリ'
'jew'	'ジュー'
'jib'	'ジブ'
'jig'	'ジグ'
'job'	'ヨブ'
'johannes'	'ヨハンネス'
'johnson'	'ジヨンソン'
'jolo'	'ホロ'
'jones'	'ジョーンス'
'jordan'	'ジョルダン'
'josef'	'ヨゼフ'
'joseph'	'ジョセフ,ジョゼフ'
'jour'	'ジュール'
'judas'	'ユダ'
'julius'	'ユリウス'
'junction'	'ジャンクション'
'jupiter'	'ジュピター'
'jus'	'ユス'
'justify'	'ジャスティファイ'
'kabul'	'カブール'
'kafka'	'カフカ'
'kaiser'	'カイゼル'
'kaiserhof'	'カイゼルホオフ'
'kalidasa'	'カーリダーサ'
'kamchatka'	'カムチャツカ'
'kamfer'	'カンフル'
'kamin'	'カミン'
'kandelaar'	'カンテラ'
'karl'	'カルル'
'karma'	'カルマ'
'kashmir'	'カシミール'
'kassapa'	'カッサパ'
'kate'	'ケート'
'katmandu'	'カトマンズ'
'kay'	'ケー,ケイ'
'kazan'	'カザン'
'keats'	'キーツ'
'kelly'	'ケリー'
'kelvin'	'ケルヴィン'
'keno'	'キノ'
'kew'	'キュー'
'key'	'キイ,キー'
'khaki'	'カーキー,カキ,カーキ'
'khan'	'カーン,カン,ハン'
'khronos'	'クロノス'
'kidd'	'キッド'
'kierkegaard'	'キェルケゴール'
'kill'	'キル'
'kiln'	'キルン'
'kilo'	'キロ'
'kilogramme'	'キログラム'
'kilometre'	'キロメートル'
'kilt'	'キルト'
'kinema'	'キネマ'
'kinine'	'キニーネ'
'kiosk'	'キオスク'
'kiss'	'キス,キッス'
'kit'	'キット'
'klein'	'クライン'
'kleopatra'	'クレオパトラ'
'knee'	'ニー'
'knigge'	'クニッゲ'
'knight'	'ナイト'
'knock'	'ノック'
'know'	'ノウ'
'koch'	'コツホ,コッホ'
'koeber'	'ケーベル'
'koenig'	'キョオニヒ'
'koln'	'ケルン'
'kolportage'	'コルポルタアジュ'
'kompas'	'コンパス'
'konigsberg'	'ケーニヒスベルク'
'koran'	'コーラン'
'korn'	'コルン'
'koso'	'コソ'
'kra'	'クラ'
'kraan'	'カラン'
'kreuger'	'クルーゲル'
'kuhn'	'クーン'
'kummel'	'キユムメル'
'kurk'	'コルク'
'kuropatkin'	'クロパトキン'
'kursus'	'クルズス'
'laboratory'	'レボレトリー'
'lace'	'レース,レエス'
'lafcadio'	'ラフカディオ'
'lag'	'ラグ'
'lahore'	'ラホール'
'lake'	'レーク'
'lancaster'	'ランカスター'
'lancelot'	'ランスロット'
'langue'	'ラング'
'lanka'	'ランカ'
'las'	'ラス'
'lassen'	'ラッセン'
'late'	'レート'
'lath'	'ラス'
'laud'	'ロオド'
'lava'	'ラバ'
'law'	'ロー,ロウ'
'lawn'	'ローン'
'lawrence'	'ローレンス'
'leaf'	'リーフ'
'leather'	'レザー'
'lebanon'	'レバノン'
'lebemann'	'レエベマン'
'lecture'	'レクチュア'
'leda'	'レダ'
'lee'	'リイ,リー'
'leeds'	'リーズ'
'leg'	'レッグ'
'leghorn'	'レグホン'
'legion'	'レジョン'
'lehmann'	'レーマン'
'leibniz'	'ライプニッツ,ライプニツ'
'leiden'	'ライデン'
'leman'	'レマン'
'lemonade'	'ラムネ'
'leni'	'レニ'
'lens'	'レンズ'
'leo'	'レヲ,レオ'
'leonard'	'レオナルド'
'leoni'	'レオニ'
'lesseps'	'レセップス'
'lessing'	'レッシング,レツシング'
'leto'	'レト'
'lexington'	'レキシントン'
'lhasa'	'ラサ'
'lia'	'リア'
'liberal'	'リベラル,リベラール'
'liberalism'	'リベラリズム'
'liberte'	'リベルテー'
'licken'	'リキン'
'lie(横たわる)'	'ライ'
'lighter'	'ライター'
'lightning'	'ライトニング'
'like'	'ライク'
'lilas'	'リラ'
'lima'	'リマ'
'lincoln'	'リンコルン'
'linen'	'リンネル'
'link'	'リンクス'
'linker'	'リンカ'
'linotype'	'ライノタイプ'
'lisbon'	'リスボン'
'liverpool'	'リバプール'
'loam'	'ローム'
'lob'	'ロブ'
'loci'	'ロキ'
'logan'	'ロガン'
'logue'	'ローグ'
'lollard'	'ロラード'
'lombard'	'ロンバード'
'longfellow'	'ロングフェロー'
'loose'	'ルーズ,ルース'
'lord'	'ロード'
'lorelei'	'ローレライ,ロオレライ'
'lorenzo'	'ロレンツォ,ロレンゾ'
'lorient'	'ロリアン'
'loss'	'ロス'
'lowe'	'ロー,ロウ'
'lucerne'	'ルーサン'
'ludwig'	'ルウドヰヒ'
'lumiere'	'リュミエール'
'luna'	'ルナ'
'lunge'	'ランジ'
'lusitania'	'ルシタニア'
'lynn'	'リン'
'lyrical'	'リリカル'
'lytton'	'リットン'
'maca'	'マカ'
'macaulay'	'マコレー'
'macbeth'	'マクベス'
'madam'	'マダム'
'madonna'	'マドンナ'
'madras'	'マドラス'
'madrid'	'マドリード'
'magellan'	'マゼラン'
'magnesia'	'マグネシヤ'
'magnesium'	'マグネシウム'
'mahan'	'マハン'
'mail'	'メール'
'majolica'	'マジョリカ'
'maker'	'メーカー'
'making'	'メーキング'
'makrokosmos'	'マクロコスモス'
'malaria'	'マラリヤ'
'malay'	'マレイ,マレー'
'mali'	'マリ'
'mallarme'	'マラルメ'
'malraux'	'マルロー'
'malta'	'マルタ'
'malte'	'マルテ'
'malthus'	'マルサス'
'mammoth'	'マンモス'
'manager'	'マネジャー'
'manchester'	'マンチェスター'
'mandolin'	'マンドリン'
'manfred'	'マンフレツド'
'mania'	'マニヤ,マニア'
'manly'	'マンリー'
'manteau'	'マント'
'mantelpiece'	'マントルピース'
'manuscript'	'マニュスクリプト'
'mao'	'マオ'
'march'	'マーチ'
'marco'	'マルコ'
'maree'	'マレ'
'marguerite'	'マーガレット'
'maria'	'マリヤ,マリア'
'marley'	'マーリー'
'marriage'	'マリッジ'
'marseillaise'	'マルセイエーズ'
'marseille'	'マルセーユ,マルセール,マルセイユ'
'martin'	'マルチン'
'marx'	'マルクス'
'maryland'	'メリーランド'
'mask'	'マスク'
'mass'	'マス,マッス'
'massachusetts'	'マサチューセッツ'
'mast'	'マスト'
'match'	'マッチ'
'maththaios'	'マタイ'
'matroos'	'マドロス'
'matthew'	'マシユー'
'maui'	'マウイ'
'maury'	'モーリー'
'maxim'	'マキシム'
'maximum'	'マキシマム'
'maxwell'	'マクスウェル'
'mayer'	'マイヤー'
'mcdonnell'	'マクドネル'
'mcgee'	'マッギー'
'mckinley'	'マッキンレー'
'mecca'	'メッカ'
'media'	'メデア'
'mega'	'メガ'
'megara'	'メガラ'
'mel'	'メル'
'melancholy'	'メランコリア,メランコリー'
'melbourne'	'メルボルン'
'melodious'	'メロディアス'
'melody'	'メロディ,メロデイ'
'melon'	'メロン'
'melos'	'メロス'
'melton'	'メルトン'
'member'	'メンバ'
'memo'	'メモ'
'memphis'	'メンフィス'
'menes'	'メネス'
'meno'	'メノ'
'mental '	'メンタル'
'mephisto'	'メフィスト'
'merimee'	'メリメ'
'merinos'	'メレンス,メリンス'
'mermaid'	'マーメイド'
'merry'	'メリー'
'mes'	'メス'
'meso'	'メソ'
'mesopotamia'	'メソポタミア'
'messina'	'メッシナ'
'meta'	'メタ'
'metal'	'メタル'
'metropolitan'	'メトロポリタン'
'metternich'	'メツテルニヒ'
'mho'	'モー'
'michael'	'マイケル'
'michigan'	'ミシガン'
'micro'	'ミクロ'
'midas'	'ミダス'
'middle'	'ミッヅル,ミツドル'
'milano'	'ミラノ'
'militarism'	'ミリタリズム'
'milk'	'ミルク'
'mill'	'ミル'
'millet'	'ミレー'
'milli'	'ミリ'
'milne'	'ミルン'
'minerva'	'ミネルワ'
'mini'	'ミニ'
'minimum'	'ミニマム'
'minnesota'	'ミネソタ'
'minus'	'マイナス'
'mio'	'ミオ'
'miserable'	'ミゼラブル'
'missa'	'ミサ'
'mississippi'	'ミシシッピー'
'mistake'	'ミス'
'mister'	'ミスター,ミストル'
'mittelstand'	'ミッテルスタンド'
'mock'	'モック'
'model'	'モデル'
'modern'	'モダーン'
'mogol'	'モル'
'mol'	'モル'
'mola'	'モラ'
'mollis'	'モリス'
'moltke'	'モルトケ'
'monday'	'マンデー'
'money'	'マネ,モニー,マネー'
'mongolia'	'モンゴリア'
'mono'	'モノ'
'monochrome'	'モノクロ'
'monotonous'	'モノトナス'
'monroe'	'モンロー'
'mons'	'モン'
'mont'	'モン'
'montaigne'	'モンテーニュ'
'montana'	'モンタナ'
'montenegro'	'モンテネグロ'
'monument'	'モヌメント'
'mood'	'ムード'
'moor'	'モール'
'moore'	'ムウア'
'mora'	'モーラ'
'moreau'	'モロー'
'morfine'	'モルヒネ'
'morgan'	'モルガン'
'morgue'	'モルグ'
'morin'	'モラン'
'morning'	'モーニング,モオニング'
'morocco'	'モロッコ'
'morris'	'モリス'
'morrison'	'モリソン'
'morro'	'モロ'
'morse'	'モーズ,モールス'
'mosel'	'モーゼル'
'moskva'	'モスコウ,モスコー'
'motor'	'モーター,モートル,モータ'
'mount'	'マウント'
'mozart'	'モツアルト'
'ms'	'ミズ'
'muhammad'	'マホメット,マホメッド,モハメッド,マホメツト'
'mulato'	'ムラート'
'muller'	'ミュラー,ミユラー'
'mullion'	'マリオン'
'munchen'	'ミユンヘン,ミュンヘン'
'mundo'	'ムンド'
'murray'	'マレー'
'muse'	'ミューズ'
'muslin'	'モスリン'
'musset'	'ミュッセ'
'mutter'	'ムッター'
'mysterious'	'ミステリアス'
'mystery'	'ミステリー,ミステリ'
'mythos'	'ミュトス'
'nachtigall'	'ナハチガル'
'nadar'	'ナタール'
'naive'	'ナイーヴ,ナイーブ'
'nakuru'	'ナクル'
'naled'	'ナレド'
'name'	'ネーム'
'napkin'	'ナプキン'
'nash'	'ナツシユ'
'natal'	'ナタール'
'nation'	'ネーション'
'national'	'ナショナル'
'nationality'	'ナショナリテー'
'natural'	'ナチュラル'
'nazareth'	'ナザレ'
'necktie'	'ネクタイ'
'negative'	'ネガチブ'
'negrito'	'ネグリト'
'neill'	'ニール'
'nelson'	'ネルソン'
'nemea'	'ネメア'
'neo'	'ネオ'
'nepal'	'ネパール,ニポール'
'nerchinsk'	'ネルチンスク'
'nerd'	'ナード'
'ness'	'ネス'
'nest'	'ネスト'
'net'	'ネット,ネツト'
'neto'	'ネット'
'neushwanstein'	'ノイシュワンスタイン'
'neva'	'ネバ'
'new zealand'	'ニュージーランド,ニウジーランド,ニユージーランド'
'newcastle'	'ニューカッスル'
'news'	'ニュース'
'newton'	'ニュートン,ニウトン,ニユートン'
'niagara'	'ナイヤガラ,ナイアガラ'
'nice'	'ナイス'
'nicholson'	'ニコルソン'
'nick'	'ニック'
'nickel'	'ニッケル'
'nicotine'	'ニコチン'
'nihilism'	'ニヒリズム'
'nihilist'	'ニヒリスト'
'nikolai'	'ニコライ'
'nile'	'ナイル'
'nize'	'ナイズ'
'none'	'アナクロニスム,レサアレクシヨン,キヤビン,デツク,ケンタウリ,ジヨオジ・ムウア,ヌウヴエル・アテエネ,ナチユラリズム,ウオタア・ペエタア,ヒユイスマンス,テムペラメント,シエエクスピイア,モネエ,ウイスラア,デリケエト,ノクタアン,マキヤベーリ,セルヴヰ,マキアベーリ,コロリン,ドッコイ,ハハハヽア,ミチエルアンジロ,チチャポン,ウルピノ,ガーフ,トフオントルローイ,プツ,コスメチツク,イスチヤ,マダカッスル,カヽン,カフヒー,スエス,カンデイア,リツプ,オツグ,ラーヴエンナ,ラツカデヴ,マダカツスル,チツキンロース,サンドウイツチ,マルダイブ,マルヂヴエ,バナヽ,イワガモ,ヒヨツコリ,ビフステーキ,ラジーン,ガツタバーカー,ウオター,ング,バラスト,エヂスン,ガツトリング,インヂン,クリツケツト,ゲラウンド,アマチユーア,オリンピヤ,チヤーチ,ドガン,ピシヤン,フーラ,マルダイ,ヒユー,マルダイヴ,ラツカダイヴ,シヤシヤン,シヤラ,ピカリツ,ナポレオン,ゴルキイ,ステト,ゾンネンシャイン,ミュンステルベルグ,アンドレーフ,アルピニー,スチュージオ,ノウヒンケツ,スピリチズム,スタチック,ツルゲニェフ,ドクインセイ,サイベリヤ,ザラツストラ,ブンベルン,ブンメルン,オイッケン,ヴァージニバス・ピュエリスク,チョボクレ,レ,ルハ,ハサルモノナレハ,ミタル,ルヘキナリ,セシハ,タレハ,セシメタルノ,ラシ,アルカ,タラシム,ナリシニ,セルモノ,レハ,セシヤ,レサリシモ,ルノ,ルモ,ユヘケンヤ,ンヤ,テヲヤ,フモノト,ヘシメ,ツヘキナリ,ルニ,スピーチュ,カラクトル,ネーサマハイイコダカラ,ニイツテハイケマセンヨヨヨヨ,プロメネード・デッキ,フォクスル,スカーツ,チャイニース・ステアレージ,ラディエター,ティーク,アリュウシャン,テノル,ステヤレージ,ビクトリヤ,コンコ,フタカチヤ,チェムバレン,ムシボシ,ツツポ,ケイマク,ヘヘヘヘヘ,ニョキ,ドエライ,オオケガ,スグキタレ,イナカホテルヘ,タラシ,アレー,アハヽヽヽ,シタ,ルイジヤナ,オホホホ,シタガ,シレ,ラセニイル,ポール・レペル,レペル,ラセニール,パヂントン,ドダイ,ウハヽヽヽ,ウハヽヽヽヽ,マアテルリング,ズバヌケ,ベツカツコ,アツビツシヨン,シエークスピーヤ,アテン,グロード,ロオマンチック,ルウズウェルト,シチュアシヨン,アンデフィニッサアブル,ヘルマン・バアル,プロテジェエ,ネルウォジテエ,シヱーキスピア,チヨボ,アキノキリンソウ,シロワレモコウ,ウシノケグサ,オタカラコウ,アキカラマツ,キタミアザミ,ツルウメモドキ,サマニヨモギ,エゾノヨモギギク,ヤマハハコ,ハマシャシン,ツリガネニンジン,カワラマツバ,オオヤマフスマ,イワガリヤス,ナワシロイチゴ,クサフジ,ポレヤナギ,イワレンゲ,エゾノヒナノウスツボ,エゾハマハタザオ,エゾオオバコ,ノコギリソウ,シロヨモギ,エゾオトギリ,センダイハギ,ハチジョウナ,イヌゴマ,ハマニンニク,ハマエンドウ,ノゲシ,ハマハコベ,イチゴツナギ,ホソバノハマアカザ,ナミキソウ,オトギリソウ,アキタブキ,ハマベンケイ,カセンソウ,イブキジャコウソウ,オチツボスミレ,シオツメクサ,エゾイヌナズナ,ノボロギク,ネマガリダケ,エゾマツ,ミヤマシケシダ,シロバナニガナ,ツボスミレ,ホザキナナカマド,メシダ,オオメシダ,ジュウモンジシダ,ミヤママタタビ,バッコヤナギ,オオバノヨツバムグラ,テンナンショウ,ミツバベンケイソウ,ヒメジャゴケ,ナンバンハコベ,ミヤマタニタデ,イワガネゼンマイ,エゾノタケカンバ,キバナノシャクナゲ,エゾフスマ,ミヤマハンノキ,ジンヨウスイバ,キクバクワガタ,イワレンゲソウ,リシリトリカブト,ゴヨウイチゴ,イワオトギリ,シシウド,チシマヒナゲシ,ヤマハナソウ,シコタンソウ,シコタンハコベ,エゾコザクラ,リシリリンドウ,チシマリンドウ,タカネオウギ,リシリオウギ,ヒメハナワラビ,ミヤマハナワラビ,チシマラッキョウ,エゾヨツバシオガマ,ホソバオンタデ,リシリソウ,タカネツメクサ,コイワレンゲ,チシマイワブキ,アラシグサ,リシリキンバイソウ,ハヽヽヽヽ,ホトヽギス,ツルゲネフ,マツクフエラー,マハーラージヤ,フアキル,ヨーギ,コジ,スミノー,ライブニッツ,クシヤツトリア,ヴアイシア,ビョウキキトク,クシクシ,ノロケ,ヤヤヤ,ケッパイ,トテナムコートロード,ポルグレーヴ,ブイアンシー,スリッパア,キシャゴ,ケムブリジ,オヴァーシュー,アアビング,カントスルニ,マントスルニ,チ,ツルヲ,ルヤ,ク,セザルヤ,ラルヽヲ,ラントス,ベ,デントス,ルガ,チニシテ,ヘシ,スレバ,クノミナラズ,ムレバ,ズルノ,シカラズ,ラシムルモノ,スルモ,カランヤ,チチアン,ザンブ,センモンセンス,ゾーポリチコン,プリミティーブ,クルッソー,エピクテータス,ハイレベルヴァルチュー,ウヰーランド,キリストエス,アイタタタタ,ギツクリ,サズ,ンダ,サシメタル,ダセバ,レリ,ナリシト,フゾヤ,セントシタリ,ナクモ,ズルモ,セラルヽヲ,シタルノミ,サルヽニ,ンデハ,クノミ,フモノハ,シカラズヤ,ラザル,フタルガ,モスレバ,カシメントシタリ,セザルトヲ,トナルヲ,ルヲ,ズヤ,ハズシテ,スルノ,レザラントス,セントス,ラハント,スルモノ,プラツトホオムヘ,リヒヤルド,スコツチ,ンチユアラー,クライマツクス,アルキメヂス,ポシチブ,ウラニオム,ビスモット,フルヲリン,インヂオム,ヨヂン,カドミオム,セレニオム,タリオム,ニクケル,コロミオム,ワナチヨム,モルブデニウム,マンガネス,チュングステン,ランタニオム,ヂデイニオム,セリオム,シルコニオム,テルリオム,アルミニオム,コロンビオム,エトリオム,チタニオム,クリユシニオム,マンガネシオム,カルシオム,ストロンチオム,オスミオム,バリオム,イリヂオム,リヂオム,プラチニウム,ソヂオム,ロヂオム,ポトアシオム,ルテニオム,パラヂオム,ソヂクコロリン,オウリオムコロリン,バセス,ヒドロウジン,ヒトロウジン,ニトロウジン,ジャア,エハハハハ,アヒヒヒヒ,トツプリ,イタイケ,ニユーヨルク,ハルシヤ,ポルチカル,ビヱン,イマジナチイブ,エニグマチカル,ジャアナリズム,ギュスタアヴ・モロオ,モオリス・マアテルリンク,センジュアル,アアチスト,テエムス,バッタアシイ,クレモン・ガアデンス,ホヰスラア,トピツク,モウパツサン,レツテル,デュウゼ,バアル,エレオノラ・デュウゼ,ロッテ・ウィット,テレエゼ,ツェザアレ・ロッシ,サルセエ,ヒュネカア,ラヴァ,バアナアド・ショオ,ジョコンダ,アアヴィング,ピネロ,センシチヴ,サタイア,サタイアリスト,ボルテーア,シユレーゲル,ヱボルーシヨン,アンニヒレーチーブ,コメデー,シンプリシチー,デリケーシー,ネヂ,シネラリヤ,ウト,ソーシャブル,コント,ビカー,ベストリー,コンヴォケーション,プレスビテリー,シノッド,コミュニオン,プリマス・ブレズレン,ウェストミンスター・アベー,サルベーション,サルベーション・アーミー,ロンドントリビュナー,ミュジュルマン,カタコム,コンクレイブ,セン・アイサーク,ホリー・シノド,ディサイブルス・オブ・クライスト,ユナイテッド・ブレズレン,エピラス,セッサリー,ルーテラニズム,エバンジェリカル,ディセンター,ノン・コンフォーミスト,アルメニアン,クラージー,パトリアーク,カーディナル,デーコン,キュレート,チャーチワーデン,セキュラー・クラージー,モナステリー,プロビンス,ダイオシス,メヂチ,ヒッカヽリ,ミンネゼンゲル,ワルトブルグ,リヰエラ・ヂ・レ,ンテ,フッシイテン,ルテル,ブマ,モヂヤモヂヤ,ワツハハ,ワツハヽヽ,ヒヨクリ,チロリチロリ,ブルツ,クリチシズム・ヲブ・ライフ,ポジチビズム,インスパイアド,センシユアル・ウオルド,オンツアマ,ピオウ,モツペ,エンヤラヤ,ヨイシヨ,シツペイ,スク,サソク,エストル,マオカ,トンナイチヤ,ンナイチヤ,ライチシカ,ストリンドベルヒ,タメルラン,アチラ,ホロドマリ,オーカ,カウスボタン,ポンビキ,イマタツアヲモリマテムカヘニコイ,サンドヰチ,ポケト,リヨカウチウユヘヒトリデコイ,イリシカベツ,メノコ,セカチ,トリキタカヘン,ダイジオコルスグコイ,ドウセダメカツテニカヘレ,トロター,ハクニー,サラブレド,クリブランドベー,トラケーネン,スプーネー,ヌツカ,シヤモ,オホナイ,ミソバヘ,ポニイ,リプ,ンヰンクル,スグカヘレ,ヘケレベツ,モコラン,クコロアペウチ,ソイワアン,フーゼリン,ヰスキ,バチエラ,シヤモカラ,シヤコロベ,ヤイシヤマネ,ヤイシヤマネーナ,カンピ,ヤイシヤマネーナー,クコロポンカンピ,ナタアララ,ヒステリ,ギリヤク,プラトフオム,モーラリチー,スコトヲ,ヘク,ルモノヲ,キモノニシテ,タヒ,トナレハ,カサルヲ,ラスシテ,ナレハナリ,ムルニ,タランコト,セスンハアル,クルニアラスヤ,ラハ,ナク,クナレハ,ルト,ルコトアル,ニセサルモノ,ムルコトアラハ,スレハ,スルコトヲ,ナリトス,ノカビテ,ヒサンチヤーゴノ,ハスシテ,ケタルコトヲ,ニアラスシテ,セハ,キモノナシ,クル,アランカ,ナラシメン,レルコトヽ,セシメ,スルコトノ,ラシメント,セラルヽ,キアラハ,ノミナラン,イーブ,ヂグニチー,チャールス・ヂルク,サルコフアーヂユ,シヨ,チプス,ベカ,アメリカマーチ,ギイーシャン,ユニヴアーシテイ,メルヴイル・デユーイ,ジエルシー,マッサチューセッツ,ペンシルヴェニヤ,レデース,パアトナア,プログレム,ビイツ,コンバルゼイション,ウォールフラワア,ドッコイショ,ズツ,ドーレ,レッソン,デフィガルト,ブラザア,ムグムグ,ガラリバタリ,ゴマカシュム,オペッカリュム,ソサヤジー,カステイラ,メネーメネー,ホワ,ユウワ,クイッキ,エンゲイジ,ライヤア,セクスピア,カチカチカチ,テケレッパ,シチン,フラネル,パナマハット,メスメリズム,ゴオールデンヘヤ,ハテネ,コセット,レセップ,シュエス,カラコロカラコロ,イイヨ,チリリンチリリン,オホホホホホ,オヤオヤマア,イケシャアシャア,ソリャア,ネエー,ミスセス,ピュロー,コハ,アワリー,ボオテ,ショッペンハウエル,マテリー,ビユフネル,ライブニツツ,プラグマチスムス,ギェーテ,トモアレバ,ルニモ,キセシナリ,リヨキ,モオシハカリ,ラルベシ,ヒテ,ニハイタルトノ,ナレバ,ニハアラズ,ナラント,シケレバ,オホカタハ,トイヘルニツキテ,アタリヨリ,トモニサバカリ,ベキニモアラネバ,リニテ,リテ,リタルモノト,トアランニハ,サモコソト,ヒナサルヽナリ,リテハ,ゼラレズ,ハザルコトハ,カレタレドモ,レズトモ,スルニ,クトモ,シタルニ,ヨリイカニ,シテモ,ギザル,ツルハ,ナドイフサヽヤカナル,ハアレド,ケレバ,リタルナラン,ヲアハセテ,ミテ,ニシテ,トアルニ,シタルナリ,ゼラレタレドモ,レル,ヘルハ,エタルコト,トスルハ,ナキ,ヒメミコト,ヲソ,ヘタルマデナル,ノアルベクモ,ハレズ,ハモトヨリナガラ,リハヒトリ,ノミナラズ,サヘ,ヒヨスベキスベモナシ,ニイハヾ,ハモト,トアリケンヲ,シタルモノナラン,ムス,イヅコマデヲ,ヘルカハ,ナラネドモ,トアリテ,ヒシハ,マデハ,バザルベク,ニメグラシテ,ヘルニハ,ザルカ,リシト,シハツ,チタルカ,ナドモアリ,イカナル,ジタルカハ,ルベカラザレドモ,セラレタルハ,アルガ,ノミニハアラデ,レルナルベシ,セシヨリシテ,リシヤモ,ルベカラズ,スラボニック,モンロードクトリン,マキャベリー,スフウェア・オブ・インフリュエンス,トクゾウサン,フレンドシツプ,インパネス,ドンキホテ,デロレン,ヴイレン,モット,センセーシヨナル,モヽモヽ,エキスカーション,セガンチニ,タラアル,クロオス,タアナア,アアト,フロオベル,ブウルジェエ,ベルジック,フェルハアレン,シェエクスピイア,アレゴリイ,パルケット,スカンクス,アルトリュスチック,フリイダ,グンヒルド,プロバビリテエ,ジダスカリア,フォアイエエ,インテレクト,アヴァンチュウル,ヴァニテエ,マッフ,ドュルタル,フォオク,オオトリシアン,プラットフォオム,ワイニンゲル,チイプ,ジフテリイ,シャンパニエエ,クリク,ポアント,ポッシビリテエ,ジグニテエ,プレオキュペエ,マルアンタンションネエ,ツウルネエ,メチュニコッフ,スエエデン,ニヒト・ドホ,ダア,タヴォオテ,ビイル,フィエルテエ,クレエム,ファスケル,マリイ・ルイイズ,エッフェミネエ,イナルチクユレエ,ハシタテ,ジョールジ,ビショプスゲイト,コムデン,オーシス,ウォーシス,ポネヒル,カラア,イヂ,ホイロ,ゴチヤ,ウムシ,オバコ,ガチヤ,スイコギ,ムシヤ,シヨクノ,ヨソイキ,シヨゲ,タヽキ,ベンカウ,ホコ,トテンチンツトン,ヱンゲージメント,ヱロープメント,モルヒ,ゾオラ,トロヽ,トヾ,ダヾ,デレリ,アラビーパシャ,アンチステネス,マニオス・キネリオス,セニル,キッチム,エリシヤ,アルワダ,ゲバル,ルイ・ナポレオン,ブラジル・パラグヮイ,パラグヮイ,オーグストス・シーザー,パーマーストン,ビーコンスフィールド,クルペー,ピーム,ビスケイ,タタール,ドニエープル,ベッサラビヤ,サガレン,レッキー,サー・ゼームス・マッキントッシュ,スチブンソン,チェオプス,オーロル,リギ,ローナルズ,ウェスタン・レイルウェー,アラビヤン・ナイト,ゴブデン,ライカルガス,ニムロデ,グラッカス,ルーコンネット,バフイロツキセラ,ブルンチュリー,ワドソン・ブラット,ヴュルテンブルグ,フォン・ビューレル,フヒフセル,ベーロー・エスローオ,アルフヒーリー・ドソステグノー,ステルン,ル・モンニエー,ミヘーリス,ヴェスビアス,ウールジー,ジパングリー,リーバー,イイカ,チュス,モンテス,セントウベス,デルハ,ラゴン,マザガン,シエルボロ,サーモピレー,イメエジ,ズヽン,アハヽアハヽ,ドヽン,ヰ,コンクワイ,コーコー,ヘツヘツヘツ,コロボツクル,クリールアイヌ,ウヰルヘルムテル,チユプカ,チユプカグル,カムチヤトカ,チコプカ,イチヤンゲムシ,クルムセ,トイチセコツチヤカムイ,ラツコ,カムシヤツカ,ダンギレ,ヤツコ,ギリヤーク,シユレンク,ゴローウヰン,スレッチャレーション,スレッチャー,セキスピヤ,ヒガネ,ビイヤホオル,トド,ケケコッコ,カワラケ,オヤオヤオヤ,エーイッ,ハギハラ,バプテズマ,アボン,タスカン,オルヒス,ピタゴル,ヲルヅヲルス,ロセツテ,セークスピア,セラフ,ケラブ,グラスメヤア,ゼネワ,ネープル,ニネブ,ヲルヅウヲルス,プロテアス,チヤイルド・ハロード,ラマルテーン,セレイ,アルハ,ベラロホン,ボレアリス,マメリューク,ベルナア,マレンゴウ,オーステリツ,ワグラム,ボロヂノウ,ロムバアデイ,ヲータアロー,セイザア,ヲータアロウ,ソヒヤ,オロチョン,カムチャダール,トイチセクル,トンチンクル,トイチセコッコロカムイ,オツトセ,シカリベツブト,シユツコハ,シユマキセル,シャグシャイン,ツクナイ,コロポッルク,コロポッル,ジヤガ,カイベツ,カシウノシラヌヤドヘウツレ,ロスケ,ナヤシ,ネキストハウス,オタトモ,シコトハシメタカヘン,ナイボ,ヤチダモ,オンコ,サビタ,ガンピ,ケンポナシ,ヌカセン,シウリ,ヱンジユ,モミヂ,オヒヨウ,アサダ,トマリオロ,チモシ,ケンタキ,スヰデンボルグ,スグイクカネオクレ,アオウ,ヒネ,サンタマリヤ,ヴヱス,アス,エピゴノイ,ヱゴイズム,ゴチャクチャ,イロハニホヘト,ドウヤラコウヤラ,ヲシ,ウヂャ,ウヤ,イケマヘン,ツイゾ,シラバクレ,グチャ,グデン,ソンナ,タラフク,サントニーネ,セメンシーナ,フラレ,ムヅ,ヅウ,ハヽア,テツカ,ガランマチカ,セインタキス,ヨジユム,ラデー,エレキトル,チンプンカン,キニツフル,ホルトロツプ,ヒユルプマシーネ,ブルツク,ヘネモコパラ,ポーハタン,ゴロチャラ,ビショ,ナマジ,チヤフヤ,マツキヅガル,アヽ,キョト,クシャ,ペートルスボルグ,ナポレヲン,アールコツク,アムストルダム,ルニヤ,コロヽホルム,コヽ,ロシフ,ミニストル・ベレクル,グヅ,ルモット,ジヨスリング,ヴエンリート,ミニストル,ドウダエ,ドッチ,ロペルト・エーチ・プライン,プライン,ドルラル,コンミツション,ソリャァ,イーエ,コンペチション,セッパ,エッヂンボルフ,シーワルト,ミシ,エゼント,ソレハソレハ,ヒョロ,ボチャ,ノソ,ブラサガッ,ザマア,ゲベル,サゾ,ツンツルテン,ホーレーキ,コヂ,コレハ,ワエ,コマンドルスキー,ドシドシコマンドルスキー,ムクチャ,チョンボリ,メッキリ,ベロリ,シブ,メッテェル,サンクロア,デッペル,キヨロ,ハンテ,メラ,ペスタロツヂ,ピヨコリ,セカ,ベアハンテ,アハンテ,ヂウ,ホヽヽヽ,フワ,コロボックル,ミシヤ,ズレバ,ナリシコト,セシコト,コロボックルニ,テザルヲ,ザルコト,コロボックルト,サヾルヲ,アイノノ,セザリシコト,トス,タイラア,ヲシヨロ,シヤムシュ,コロボ,チャンバアレーン,メモアー,コロボクグル,アイノニハ,ザレトモ,シャムシュ,シタレバ,モゾクサ,ウヨ,ホガラ,ジヤブ,パサ,ゴボ,ツク,ツアラトウストラ,ナマケル,シツッコク,ノーミステーキ,コッパイ,ユツタリ,リョウマチ,ッポチヤ,ハヽヽヽヽヽ,ハヽヽヽ,ハヽヽヽヽヽヽ,シチウ,ギューリッキ,ドブン,アヽアヽ,ザーイ,ホヽヽヽヽ,テテンテン,ヂユク,ヤートコセ,チヨコ,カメノコ,ビシヨ,ンデ,ナラザルニ,クハ,ラザルニ,ナカラズ,ラントシテ,ツハ,ヘザル,ビザルモノ,メバ,ヒヲ,クナルヤ,ヲシテ,シタルハ,ギタルハ,シキハ,シカラシム,レシム,ラレ,セシメバ,シムノ,クシテ,メズンバ,マシメン,ソンナラ,ペツ,ホホホヽヽヽヽヽ,ヨカツタ,ソツチ,ヅン,コローム,ヅキン,カウカケ,リイダア,チヤンカラチヤンカラ,アヌンチヤタ,ペリクリース,シツポリ,アノナハーン,アェヅダケァガナハーン,スアレー,アナーハン,ハンモ,タケスカ,ニソダチナハン,アレガラナハン,ルヅギモ,ガタンチエ,ホリヤ,ダタアンステァ,ヒヨウ,ホーホケキヨ,シタタカ,ローゼツタ,トマス・ヨング,シヤムボリヲン,ヅカ,アツケデヤ,アレキサンデリヤ,エハンテ,ニタ,ヨシキタ,ソレヤマタ,ドツコイシヨ,ヨシキタホラ,ソレヤマタドツコイシヨ,キタコラサツサ,ツオイス,ギヤツ,アザレエ,ロドダンドロン,クウウェエル,ジュポン,ウォラン,ブリュネット,ウラヂオストック,コジンスキイ,コジンスカア,ウラヂオ,フィリステル,シャンブル・セパレエ,シェリイ,チェントラアルテアアテル,ブリュウル,ウェエル,セントペートルスボルグ,アハヽヽヽヽヽ,ドーダ,エンギ,ルールブリタニヤ,ルレム,バシーオ,ヂョセフ,ン,マガリタ,シムプル,ロマンチケル,エキゾーチシズム,ウエド,ミサキ,オソメ,アビラウンケンソワカ,アブラオケソワカ,ソワカ,クサメ,ゴツチヤ,ホホホホホホホホホ,クリッフォード,ギュッツラフ,ボナハルテ,パニ,プー,ウプ,オホ,スプユン,クラプロート,パジエー,ウエンクステルン,アパ,カパンカパン,ヰルヂー,トロバヅウル,ローヘングリン,スタヱル,クミチンキ,ヘレーン,スペーク,エングリツシ,コロガシ,ウオルズウオルス,ドロセヤ,リヒヤード・ワグネル,ルツス,マルビキユーリ,ガーフイルド,ユージェニックス,ハックサメ,ディッキンス,スクルジ,ソシアリティ,ビアトリース,ヴェロナ,ウェルビッツカヤ,ボカチオ,メニツエル,ウォーズウォルス,リウク,エキスカルション,ソンネット,プルシャンブリュー,ルレエヌ,デーモクリトス,アナキサゴラス,オクテヴィア,オクテヴィヤ,チャーミオン,ゴージアン・ノット,ゴージアス,ロゼッチ,ジェーナス,ハムエクス,ヌーボー,チッペンデール,レオパルジ,メレジス,エポッペエ,コンコルト,ストラスブルグ,シュッベルト,トラジション,キタツパラ,テツペン,ウコギバラ,スミツカリ,サヽクレ,オッキイ,スベキモノヽ,セシ,ヰラレタルナリ,ヘハ,ヘシヲツド,カチテ,ヤサレタリト,ダセルモノニシテ,ナレドモ,シタルモノナリ,ヰザル,ヒタルモ,セザルナリ,ハルヽニ,リシ,ハレタル,ナリシガ,ハレタルガ,リシナラントノ,ケタルナリ,スウィッツァーランド,サレタリ,ダセリ,リタルモノナリトノ,ニウギニヤ,ズンバ,ハズトノ,ラルヽモノ,シタル,ダサンヤ,リシモ,リシトノ,スルノミ,ヰタル,リトスルモ,マリタルモノニハアラザルナリ,トハ,サルヽ,トナサンヤ,ナリトハ,ハザルナリ,ナラズ,ヱジプト,ノモノニ,グガ,ダサザル,リトハ,ニウジイランド,ラザルナリ,カニスルヲ,ベキハ,ノモノナリトハ,ニスレバ,ナリトモ,ベカラザル,ニハアラザルナリ,カラザル,サレタル,メタルニアラズ,ジタルナリ,トナスヲ,ニスルノミナラズ,ナリシカ,セシモノハ,タリシ,リシナリ,ナラザル,グレバ,リシヤ,ニハアラザリシナリ,チテ,リシガ,ニテハ,ベテ,キテハ,ヘタル,キタルガ,トスベキモノ,シタルモノ,チシ,ヰシ,トシテハ,トセシ,ベキナリ,セシカ,スルカ,スルヤトノ,シテハ,ヘバ,インヌイト,ノモノト,カラズ,レドモ,メドモ,ヅク,スレドモ,ナルニハアラズ,スベラズ,ジタルヤモ,リタルヤモ,スベキハ,レザルナリ,カニスルニ,ナルノミナラズ,カラザルナリ,レタル,チタル,シトナス,スルモノナル,リシカト,サレシカト,カリトナス,フベク,カラズト,フベキナリ,モドカシ,ヱツフヱクチプ,アンドレヱフ,コンポジシヨン,ハテ,ゴシリゴシリ,サラット,サラット・チャンドラ・ダース,ラハサ・ビラ,モンゴリヤ,セーラブ・ギャムツォ,シャブズン,ツーミ・ウォンデン,ラマ・シャブズン,センチェン・ドルジェチャン,コンボ,ニャートン,カンチェンジュンガ,ボーダ,ジッバードル,ブダガヤ,ダンマパーラ,セゴーリ,ジェ・ターサン,シャッベー・シャーター,テンゲーリン,ブッダ・バッザラ,マーヤル,ビチャゴリ,ビンビテー,チスパニー,チスガリー,タイガヒル,ヤンブー・チョェテン,ヤンブー・チョェテン・チェンボ,チョェテン・チェンボ,ルン・カーショル・チョェテン・チェンボ,チャチーマ,テンリー,ニャアナム,キールン,シャルコンブ,マナサルワ,マパム・ユムツォ,リンボチェ,ツクジェ,カンプラチンキ,カックー,ハルカマン・スッバ,セーラブ・ギャルツァン,チュミク・ギャーツァ,ムクテナート,サーラ・メーバル,チュラ・メーバル,カリガンガー,カルジクパ,ツァーラン,ニェルバ・タルボ,レクシン,ゲーセ,ビンドラバン,シャクパ,トルボ,ゲロン・リンボチェ,ニェンダク,サッキャア・パンジット,ソェナム・ノルブー,マハーボーデ・ソサイティ,ダンカル,ターウ,ターシータン,ターシンラ,ツァルカ,カン・リンボチェ,ゲロン・ロブサン・ゴンボ・ラ・キャブス・チオー,チャクワン,シカチェ,パンチェン・リンボチェ,フェリス・ユニガ,チリヂリ,キャンチュ,ラターク,アルチュ・ツルグー,アルチュ,アルチュ・ラマ,ワンダク,タムチョク・カンバブ,ブラフマ,バアーッ,チェマ・ユンズン・ギチュ,ズクズク,コン・ギュイ・カンリ,チェマ・ユンズン,チョンポリ,エジュアス・ヘミオニス,ダム・ギャショ,チュミク・ガンガー,チュミク・トンガア・ランチュン,チーセ,ジャンブ,マブチャ・カンバブ,ランチェン・カンバブ,センゲー・カンバブ,サルワ,ツェコーロウ,ラクガル・ツォ,レーク・ラカス・タール,カン・チーセ,ハルダハル,コケラ,ンガリ,クーヌブ,ギャア・ニマ,ギャア・カルコ,ミルム,ダアワ,チャチャン・ペンマ,シュウッシュウッ,チュコル・ゴンパ,プレタプリー,トクポ・ラプスン,パンデン・アチーシャ,ズクパ,ギャルワ・ゴッツァン・パー,ロボン・リンボチェ,タルチェン・ターサム,チイコル,パルコル,ナンギイコル,ニェンボ・リーゾン,セルシュン,リ・ラ・プリー,ズンツル・プク,ゼーツン・ミラレバ,ハムフンギチュ,ギャンター,ドルジェ・カルモ,ポンリー,トクチェン・ターサム,ニョクチェ,コンギュ,プートー,マルツァンギチュ,コーベイチュ,ンガル・ツァンギチュ,ナーウ・ツァンボ,トクスン・ターサム,ターサム,サムツァン・ターサム,アジョプー,タズン・ターサム,タズン,ルトウ,フンツブ・チョェテン,ツォンボン,ギャルツァン,ニューク・ターサム,ハルジェ,ペッマ・チュンネ,セムナク・ポェパ,ポェパ,ポェ,テーウ・トンマル,タク・シンモ,チャクサム・ツァンボ,チャクサム,サッカ・ゾン,サッカ,チョモ・ラハリ,クル・ラ,ギャートー・ターサム,セースム・ゴンパ,ターサン・ゴンパ,マヌユイ・ツォ,ラールン,ナム・ツォ・ゴガ,センゲー・ルン,ナクセー,サッキャア,レンター,ヒワダ,サッキャア・コマ・リンボチェ,チャ・ゴッポ,タシ・ルフンプー,ニュン・ネー・ハーカン,ルフンプー,ゲンズン・ツブ,ピーツク・カムツァン,キャプコン・チェンボ・チョェキ・ニマ,ツァン・チェンパ,サンバ・シャル,ツァンチュ,ペー,ングルチュ,ツーミ・サンボーダ,ポンボ・リーウチェ,ニャーモ・ホッター,クルム・ナムセー,シャブ・トンツブ,チャム・チェン・ゴンパ,ターミラ,スン・チュン・ドルマ,チョェ・テン,ジェ・ゾンカーワ,ドルジェ・ギャルポ,ロン・ランバ,キャーカ,チム,ター,ンガ,ツァム,シクナ,ヤクチュ,チェスン,ンガクバ,ラー・リンボチェ,ヤーセ,ヤムド,ヤムド・ツォ,パルテー,パルポ,ゲンパラ,ラ,キーチュ,ポタラ,コーワ,チュスル,ナム,ネータン,シン・ゾンカー,ツェ・ポタラ,ツェ,ソンツァン・ガムボ,ビシュカッマー,バンデーシャ,ナムサイリン,パテー・カムツァン,ラートェパ,マエ・ターサン,ンガクバ・ターサン,カムツァン,サムヤエ,トブテン,ツォーチェン,ラハーキャロー,チョエン・ジョェ,ゲ,ツァンニー・ケンボ,ドルジェフ,ンガクワン・ギャムツォ,タワ,チョェ,タシ,ノルプ・リンカ,ズーニェル・チェンモ,チョェ・ボン・ケンポ,プーツク,ジェ・リンボチェ,シャッベー,ターサン,ギャミ・メンカン,ワンズュ・シンカン,パナンショー,カーチェハカン,アニサカン,チャムパ・チョェサン,テンジン・チョェ・ギャル,ツァ・ルンバ,ペートン,チョオー・リンボチェ,セライ・アムチー,ジンギスカン,バーア,ツァルン,ショ・カンワ,チャ・チャン・ペンマ,ヌーリン,リンチェン・ナーンガ,トルマ,シェッパ,ギイー,チェマ,サースン,ルクソー・ミンズ,テーモ・リンボチェ,ノルプー・チェリン,ドーリン,ションケー・ラムカー,ヵ,ツァ・チェン・ノルプー,ナクチューカ,ポルデノーン,ドルブィッル,プッテ,プレゼバルスキー,タッツァンルー,チョーマー,イェスキー,リンコル,カルマーワ,ゾクチェンパ,ロボン・ペッマ・チュンネ,ベルチスタン,ダナコシャ,ゾンカー,ジェ,ネーチュン,ラーモ,シリー・ゴーミ・テンジュン・チョェ・ギャル,ポェ・チーコル・チュスン,ガートン,メトーケーサン,ゲルバ,ボ,シェーゴ,ヤブシー,ニャチー・テーツャン,ラハーキャリー,デーボン・チェカー,ポンボ,トムバ,テク・タ・リル,ハーチェリン,セルコ,イ・タクラー,ナンプ,チンマ,チンチー,デーマ,コンボチェリー,チェーカ,ショカン,カーチェ,サンジョェ,ズク・ニョン,ツン・イク・チェンモ,パーツク,ムーチク・ギ・シャーモ,エーゴル,セルキ・カーウ,タラー,ペンバ,ニマ・チェリン,ダアワ・プンツォク,チョェ・ミン,アゼ・ハアーモ,ピョイピョイ,ツァーツク,ネーチャン,ベーチャン,チャンサ,ブリヤッド,ドルジェ,ツァンニー,シャーター,ジャムヤン・チョェジェ,チャムバ・チョェジェ,チャン・シャンバーラ,シャンバーラ,チャン・チュブ・センバ・センバ・チェンボ,ダンリーワ,パンデン・ラハモ,チュンビー・サンバ,スッバ・ハルカマン,ガンデン,シャーゴ,カムツァンギ・ギケン,チュンガ・チョッパ,クショ・シャーター,クショ・ショカン,クショ・ホルカン,ラハ・ランバ,ゲーセー,ツォー・ランバ,ドー・ランバ,ラハ・カンバ,トーキャ,トェカー,ウーウーウーウー,ガンデン・チー・リンボチェ,ラブラン・チェンボ,ツェ・ラブラン,ナムギャル・ターサン,ギャンチェ,ゲーサルギ・ギャルポ,シャブズン・ラマ,ツプテン・ギャムツォ,タクボ・ツンバイ・チョェン・ジョェ,タクボ・ツンバ,クショラ,ツェモェ・リンカ,ヤブシー・サルバ,チョェン・ジョェ,ツェ・モェリン,ニンジェ・イセー,チー・リンボチェ,チャンバイセー,ツァーリー,ゴーリサンガ,ギョクポ・ペブ,コーチャクパ,ラーギャブパ,テンバ,ジャンマェ,ジャントェ,ペンバ・プンツォ,ターマルン,ナンカツェ,ザーラー,ネーチェン・カーサン,ラルン,ツァナン,パンコル・チョェテン,ラハム・ツォ,カンブーロン,サンワイラム,ラハムマェ,ラハムトェ,ピンビタン,トモ・リンチェンガン,チュキャー,ダカルポ,チョェテン・カルポ,サタ・ダルケ,ナクタン,スル,ゼーラ,ツォムタクバ,ボェトン,プチュン,チスター,ラブチェ,チークム・セーロン,ランニー・ウンラム・ホクラム,サーチェ,クスドム,タクボ,カハー・アドミヤハー,バンキープール,マッチンセン,サラナータ,ベザント,ケダルナート・チャタルジー,シマン,ビールガンジ,バヒセ,クリカネ,チャンドラギリー,クショ・ロケラ,ボウダ,ソボロ,タヾ,ユツクリ,ブク,ジヨキ,アッコンプリッシメント,ドッペルゲンゲル,ユニヴァサル・サアカス,ローズア,ポオル・ゴオガン,ヴェトウェン,メィフェスト,カアブ,アンニューイ,サアカス,サルフィユ,コールテーア,マコトノヨ,ヒトリノオナゴ,ヒトリネミドリゴ,ハハノウデ,ヒッス,ヒャア,ウィリイ,イマジナティヴ・コンポジション,イルミネイション,コホンコホン,カアバス,カアレンダアス,カアマシャアストラ,ファンタステック,チヤキ,ホツ,ズウデルマン,オゾ,ヱンゲーヂ,ザワ,ヒッソリ,リンリンリン,テッテチチンテッテチチンリンリン,ビイヤホール,ガアゼ,フリツ・ルンプ,カワヤナギ,シラベ,ミヤマカンバ,ミヤマナナカマド,ベニハナイチゴ,ジムカデ,タカネツメグサ,トウヤクリンドウ,イワオウギ,ミヤマダイコンソウ,チョキリ,キイツ,ロセッチ,サエレン,レズ,スゾ,ケレ,ヘタランニハ,シケレド,セルモノト,セシモノ,バジ,グ,ノモノトテハ,タレバ,サネバナラヌト,フコトモ,ラネ,キコトハ,ヌレバ,ニテイト,メタルモノナリト,タラントス,スルモノハ,セシモノニテ,ラズトス,アウレリウスノ,ルモノナリ,キシコトヲ,オルカニヤ,アクチーフ,パッシーフ,シヨボ,チヨロ,モヂヤ,タカヂヤスターゼ,デツプリ,ハツハヽヽ,チヨコナン,アノ,シツトリ,ヨラ,シタリ,ホホヽヽヽ,ハヂケ,ホホヽヽ,スタ,ククヽヽクウ,ドヾドン,ドヾドコドン,ヨサレ,ヒユウ,タヲル,シガア,マツサアジユ,サジエスト,ポツシブル,ポツシビリチイ,ドキンシイ,ヒョクリヒョクリ,シォール,ステエション,ハヴァナ,フエアクリイム,アイスクリイム,スプレイ,ツィシアン,ゲエム,チョオク,エッセクス,シォウル,ネルトン,テチンチンツン,チツンチツンチツン,エエエエエエエエ,ツンツンツンテツテツトン,テツトン,イイイイ,チチチチンチンチンチンチンチイン,ミレエジ,ヅイ,ヂンダ,オスゴレ,ゲエープツ,ハハハハゲエープツ,チヤアン,ヤツコラマカセ,ムニヤムニヤムニヤ,アイタアイタ,ハタリ,オホホホホ,パチリバチリ,レンチヘン,ザザーツ,ブツサキ,ハハヽヽヽ,ギツシリ,サカンニヤレ,ハハヽヽヽヽ,クドイ,ラハエル,アルハラヤ,ダイヤナ,ヨハナーン,ヨハナン,ドタン,ペロ,アスパロガス,メトロポウルホテル,タアシヤー,サモワル,コウゴジ,ヒイヽン,キツヽヽ,キヤキヤ,マガレット,エビスビール,ベポアー,ツランクイリチー,ブレエキ,アハヽヽ,ドバ,ハイポセシス,ヴェリフィケーション,ヘヽエ,ミステリイ,イヽエ,レコック,ホジクリ,ヘタヤタラ,ユーゼニ・アラム,ツマラヌ,ガンチャローフ,ベリンスキー,トライアンビレート,ドウシテモ,アイコノクラスト,ケサミセヤケタ,ベチャクチャ,ガチ,ラデューム,プラグマチズム,リブレール・ド・ボザール,デューシエ,ヘスリンク,デュポン・トーベルヴ,ヴヮンダイク,スチュヂオ,ヂャーナル,マイステル・デア・ファーベ,グラフフヰ,ック,ウォッヘ,ビブリオグラアー,ドウダネ,ヘーゲ,ジェシュート,エズイット,ロレンツ,クワーリッチ,ヒールセマン,ファクシミル,ストリンドベルグ,ウェルタール・ウント・メンシハイト,シラギントワイト,ハウフ,スペンサア,バチルレン,ペツテンコオフエル,ワンデツタ,ニスルニ,セシニ,ルマテ,ハラサルモ,セリタヾ,レズト,タルド,ビステキ,ビステッキ,セピヤ,アダジョ,パァージャル,コダワ,ジアス,エジプシアン,カルチュアー,ナタラ,ワアーワアーワアー,ウハーウハーウハー,ドタヽヽヽバタ,レオバルヂ,ヴァイティピ,アティ,ヱルレエヌ,ブレトン,バーガンデ,ラ・ベル・ジャルダン,パヴィース,ギージ,ゴーゴン・メジューサ,ジプシイ,シワルド,ワルハラ,ボーシイル,プロヴォンサル,シミニアン,マルテロ,ドルエリ,ギウ,ヘルバロト,ペスタ,ヨウヨウ,ワッショウワッショウワッショウ,ワッショウワッショウ,ヤッチョウヤッチョウ,ブレメン,プテオリ,カルメット,ウィーゲル,ソーマトランパス,アンリ・スタンフィーバン,パシュフォード,マスケゴン,クイーンスタウン,ドイチュランド,フォーゲルベー,スピツバーゲン,クリナンダイアモンド,デボンシャイア,ウードジョーンス,アルダーショット,ポルダ,トッパズ,サッファヤ,マジョラ,モーレタニア,ウワーナー・ポオリー,ヴェスヴィアス,ミスシッピイ,エチール,ペルジョンノオ,メルザル・ベル,ド・ラグリー,ボンニエー,クニューデン,バルチモアー,ペツタ,スルハ,オックスホード,オックスフオード,レシプロシチ,エクウオリチ,ステフェンソン,エネミ,マルチルドム,スピイチ,オブセルウェーション,リーゾニング,フランキリン,ガルハニ,トーマス・クラレクソン,マルチン・ルーザ,パガン,ラアゲウィッツ,メエルハイム,デウベン,ビュロオ,ショッセエ,ピラミイド,リフレエ,トルウヘ,ファブリイス,ブラウンシュワイヒ,ゾファ,シャルトリョオズ,ブリョオゼン,キッテル,ムッチェン,ゼエ,ストラアセ,オースタリア,シュロス,ショオンベルヒ,ポロネエズ,アラヽギ,ツルガオカ,ツルオカ,フクジマ,カナザワ,カネザワ,コガネザワ,キンザワ,ドウメキ,ザワメキ,ガラメキ,コウチ・カワチ・カッチ,タワ・タオ・トウ,タワ・タオ,ウワノ,ユラグ,ナラス,ホキ・ホケ・ハケ,ナイブ,ビユ,ホノキ,ホノキ・,ミョウ,フレ,ダータ,ホヌキ,タオ・トウ・トウゲ,ユラ・フクラ・メラ・カツラ,ユイ・タユイ・タゴ,バチェラア,コンニ,ノタ,クテ,クゴ,グデ,ヤト,オオサコ,ウーザコ,カヌガ,ハンバ,クエル,ガケ・ガンケ,ホキ,カケママ,ママックズレ,コバツクリ,コバキリ,サス,ゾウレ,ヒラコ,ニイノイ,ヒウラ,ヒオモ・ヒナタ,アテラ,ケワイ,オサル,オサ,カワド・カード,カワド・ゴード,ドドメキ,アシダニ・アシノタニ・,ヨラキ,ミョウショ,ホノギ,シメ,セルト,トオ,クハラ,マロクヌギ,コノギ,クヌキ,ヌ,クニキ,メメナイ,エドモ,ノツ,マオイ,エンルムカ,エンドルム,ドウマ,ニタト,マカド,フクラ,フカホド,クボイ,クボム,クボ,ゴウラ,ゴラ,ゴウロ,ゴウロケ,イシゴロミチ,コウロ,コウゲ,ニッポコウゲ,カグ,コーゲ,クサネム,クサッパラ,カガハラ,カカボ,アメノシタニカガアラシメ,コウガ,ペネプレエン,ペネプレーン,ナラシ,ナルシ,ナルボラ,ヌタナロ,ナルジ,アクツ,アクタフ,アクド,アクソ,アケド,アクツ・アクト,アクタ,アクタ・アクト,アタラ,クサマキ,アテガ,アテビ,アタル,ハンタテバ,ハシバ,クライシ,サガラカ,シガラキ,ウハラキ,オハラギ,ウマラキ,コウロキ,コウラギ,カブロギ,カラズマイ,カリアツマリ,アツマル,カリアツメ,タメ・アツメ,ソリ・ソウリ,ソリバ,ソウレ,ゾレ,ソレ・ソウレ,ゾウラ,ウレ,ソランバタケ,ソラス,ヒトクボタ,アンフィシヤター,ヒヨ,タケガヒヨ,シメツクシ,ツクシモリ,ヒヨ・ヒョウ,ナカヒョウ,ビョウ,トウカンビョウ,ナカビョウ,サカイノシメ,ヘウ,タカハナワ,パナワ,ヘオ,ヒョウギ,ツクス,ホシイイザワ,カレイザワ,カルウ,ツウカルイ,カラグ,サンキョ,タヤ,ブンジ,ヤチ・ヤチッボ,ヤチッベ,ホーフ,ネガラ,ネガラミ,カラマル,カラマク,ドエ,パナ,エノハナ,ハッケ,バッケ,イワハケ,ノポリパッケ,ノポリ,パッケ,ペシパケ,ニクルパケ,ニクル,ヤゲン,ウトウ,ハシダテ,カクマ,カクノ,サカ,ネエボリ,オタ,マクリ・シワナグリ・イスズグリ,ワリグリ,ゲザイ,タタラサワ,タタラギ,トツラ・トウマン,トツラ,ツツラ,カネタタキ,ハテ・ハシ・ハチ,イタヤグシ,イグシ,ミテグラ,コペルニカス,トテッポーッポー,インフィニテー,ハシャギ,ゲネパ,ブツリ,トレヴィラヌス,ロッペン,ツブヤカ,トッピキピーノピー,マヂニー,スガリ,ワスコ・デ・ガマ,ザウィエール,モントニーグロ,クロンウエル,ジャメイカ,オコツク,シロテ,カムサスカ,アウス,レザノット,カムサッカ,シモシリ,チルゴー,ライコルガス,ボウパタン,タクチック,アー・ゲー・アーフアンラブハン,コロートヘルトフ,ポナパルテ,ミニストル・ハン・コロニイン,ペスタロジ,ザウイエル,カヴル,マジニー,イラスモス,ウォルテール,アレキザントル・ハミルトン,ハレール,セイー,ロベスピール,コンドルセー,メテルニヒ,ロンバルト,ゼシュウイト,ウオムス,アウクスボルク,ニウカムス,ヂツケンス,ヒツクウイク,ウイルキー・コリンス,イビル,ワシントン・アービンク,ブレツト・ハート,ガンチヤロフ,ビーコンスフイルド,チェンチェンツーツー,ビューウ,ドストイヱフスキー,ドスト,イワーノウナ,ユーゴ,ミゼレハル,ウオタアヒヤシンス,ダアリヤ,シユブタ,シヤンヲウ,カツクカツク,チツクタツク,ガメノシユブタケ,ルネーサンス,ザー,インアリエネブルライト,ウウーム,ネズダノオフ,スィータスィータ,ウイスドム,フイロソフアース,スリガラス,ノンドリ,ジヨンマーチ,キヤラバン,ムツクラ,ピツシヤリ,ギラ,シヤイロツク,トッピキピ,イツデモ,ビェリンスキー,ディッケンス,レルモントフ,グレエ,ダンチェンコ,イユメニエフ,ツモリ,ポジティヴィズム,シンネリムッツリ,ヒューマニチイ,フィロソファイズ,アーシャ,ドラッジェリー,アドマヤラー,ウィオリノ,ウィオリン,ノーウ・オウレーミヤ,モスコー・ウェドモスチ,ピルスウツキー,ウツケ,マレウイチ,ブア,ブローウィツ,ポルトセイド,パセパンシャン,ロックフェラア,ヤヲ,キヨウサンシユギ,ハツハ,サメザメ,イスカリヲテ,テカ,チヤンチヤラ,オホヽヽヽ,オホヽヽヽヽヽヽ,ホダ,コウト,ピチ,ペテルブスキイ,ハヽヽハヽヽヽ,フヽン,グウーツ,カンラ,ハヽヽヽイヤ,ホヽヽヽヽヽ,ウ,ツ,ワメ,チリヽン,ノサ,ムセ,オホヽ,イハヽヽヽヽ,ヘヽヽヽヽ,ビシヤリ,ウァイオリン,イヨウ,ワハヽヽ,ガパ,ドツ,フヽム,ケタヽ,パティキュラー・ケース,モーチブ,ドツカ,ソハ,コロコロコロコロ,コロコロコロ,カタカタカタ,アルコオル,チョキチョキチョキ,レエゼウッフ,ギョウテ,ボコポン,ヒイイン,ツタビョウキ,スパリスパリ,ガジャガジャ,ゴシンゴシン,テクル,グショ,ウンコラウンコラ,ハイヨウハイヨウ,ガッタンガッタン,ビール,グーグームニャムニャ,エーヤッ,ヒーン,ボコタリボコタリ,ヘゴロチャラゴロチャラ,ヒョロクタ,ヨシヨシ,キョロ,イリユウジヨン,テクニク,アンドレエフ,ヂレツタント,マネエジヤア,シユウツ,ステイチョン,アンチセシス,ヘダ・ガブラー,ノウレジ,ロペルトピール,マツヂニー,サリスバリー,ガバーメント,チヤムバーレーン,ヂルク,ヂヤスチン,マツカーシー,オヴヱンデス,ジスレリー,ダービー,ストラツグル,アリストクラチツク,ガムベツタ,チエール,ガリバルヂー,ヂミ,オーコンネル,モツブ,ワリエテエ,ランスチチュウ・パストョオル,トラワイェエ,マドモアセユ,シロジロ,チウベツ,チウ,ダガネ,イイカネ,マワリ,マセマチカル,コロック,ソコニハ,ドンゾコ,ブンマワシ,デングリカエシ,コロガリ,サツパ,バシヤリ,プーツ,アツプ,リツトン,ゴドルフイン,シヤガ,センツバ,ワキギ,ドクダメ,シヤウブ,マンション・オノレエル,リオナルドオ・ダア・ヰンチ,ミュンステルベルヒ,ウエンチ,プットバリー,レヴェレンド・シメオン・ピジョン,ピキシー,インスピレイシヨン,ヲフヱリヤ,マーガレツト,ロメオ・アンド・ジユリヱット,ニャァ,ガラリン,ヒュウドンチャン,ドッチョイ,ストトントン,ザザンザ,ケエヅ,ショオウィンドオ,ェ,ザァザッ,テンツルツンテン,ツンテンツンテン,フッツリ,チリツテシャン,バンビク,ヴェステンフェルド,ヴ,オルコン,ラドロフ,ラシッドウッヂン,ドオソン,ホウォルス,ベレヂン,アルゼリイ,ファラリイス,アルゼリィ,コォト,ヒュヒュ,ネシユダノフ,ドガア,クラリオネツト,トラヂシオン,サンチマンタアル,トングスバス,ムスリン,ロオズマツダア,ホラチウス,ヰツスラア,ピエエル・ロチイ,スカウト,チヤノユ,スロアアガ,ヨオイイ,コマシヤクレ,テクリ,エミタヾカツ,ブンシ,ミルクホール,ヱ,コシン,ザレ,ウオヴレ,ハイカ,リーデルゴノサン,アラボシ,ポマドンヌール,ラリア,アームズト,アハメル,コメデイ,トラゼヂイ,ソホクルス,フヱーリイ,ヱンゼル,メヒストフエリス,シヱークスピア,フオウスト,ネゲイシヨン,ネガチーブ,ウイツチ,セタン,エターニチイ,プレルレル,ゴルテル,ゲールト,ゼーンス,デンニス,ミュトロギー,オイエメロス,パレフ,オイエメリスムス,ロマンチィク,ゲルレス,ンク,クリスチヤンゴットロープ,カドモス,ケクロップス,エロイツェル,ロベック,ゴットフリード,タイロル,フェルステマン,オバステ,オハツセ,シノバズ,ヘロ,レアンデル,マオリ,ブラーマーナー,エッダ,メールヘン,シュワルム,ハーゲン,キルヒホーフ,エンヅンムート,ケルレル,オウィォド,メタモルフォーセス,バウチス,ポリーア,クリスネン,オディスセー,ホルレ,ヲドスコフ,ライストネル,ミュルレンホフ,ナルチス,キバリッソス,ベリデス,エブ,ホッテントット,ツェレス,ペルセフォーネ,アイオイナカムイ,ユダス,メドゥーザ,ペルソイス,ツォイス,ヤーゾン,ウシャス,アシウィン,ワルナ,アグニ,オリムピヤ,ヘファイストフ,ポサイドン,アムフィトリテ,ボレアス,ノートス,ツェフロス,ポリネシヤ,タンゴラ,スカンヂナヴィア,プルシヤ,スークタ,スカルト,サタパサ,フラガーハチ,ヴテア,エムベドクレース,エピクール,フェニシヤ,プラーマ,パシアン,タネマフタ,イグドラシル,ツヌ,エレクトリオン,アルケメーネ,ミニア,デルフイ,ミケチイ,オイリストイス,エリマントス,スチムファロス,ディオメーデス,オイリストス,ヘシオーネ,ピロス,ラコニア,テスサリア,アヒリス,ミルミドーン,ペロイス,ネロイス,プリアムス,ヘカーベ,リノーネ,カスサンドラ,アミクライ,メネラオス,テゾイス,ニーベルング,ローキ,ヘニール,アンドワリ,フライドマル,ファフニール,レギン,ミルチロス,ヘファイストス,ジーグフリート,プロメトイス,ピルフォロステオス,ソフォクレース,ペロポンネス,シキオン,エピメトイス,ヤーマー,イーマー,ニンフォー,コルンブルヒ,ホルガー,ダンスケ,クラルエヴィッチ,オギギア,ドイカリオン,ピルラ,オツリス,バルナッソス,ベルゲルミル,フリッツネル,ラルナックス,アンドレー,アビスス,キュピット,チマルポポカ,バーガヴァタ,モハメット,カレヴァラ,レムミンカイネン,ブシュマン,マラガシー,マダガスカール,サモエード,ダホマニー,ヘラレクス,メヅーサ,グレルト,ライネッケ,ウフラカニヤナ,アルフォンスス,オイローパ,ダネーエ,アクリシオス,ラコニヤ,ティンダレオス,イカツチ,オイリディーツェ,プルトー,プシヘ,アプレイウス,エヌス,ウルヴシ,プルラヴァス,オジプエイ,ファルレル,アルゴンキン,ワルキリア,オディスソイス,カリプソー,アイゼンバッハ,サルブツ,トコヨノクニ,ホドソン,ウォラシーヌ,エフェスス,マキシミアン,マルキアン,セラピオン,デシウス,セリオン,フォーティウス,マモメット,オイティウス,エピメニデース,エンディミリオン,エルフ,ハウアド,ヒヨツト,シヤクリ,オヤモウ,ハヽイヤ,アハヽヽアハヽヽヽ,デモクラチイ,デモクラチスム,ポリグロツト,ベッタ,ツルシ,スリエ,ジョーワニ,ヘベライ,ヘンホーライ,ワグマン,シホホロ,トメルベシベイ,オヨチ,クンベツ,ノフノヤウシ,ウエンベツ,イカイラン,ニオトマム,ヤエンオツク,シオポロ,センビリ,イコサックル,ニタトロマップ,シシリヤ,ヨオド,ニコライ・ペトロヰツチ・キルザノフ,バザロフ,シウベルト,ゴホ,チギ,センネモドン,イヒドリ,ヱヘヽヽヽヽ,フヽフヽ,シノベ,トーハゼ,スハジカミ,ハジカミコン,シヤウバイ,アキナヒ,ソチ,コノワラヅトウナドニハ,イカウケイヅノアルモノヂヤ,ケイヅ,スキハリシヤウジ,カラカミシヤウジ,フルツク,ホーソ,ノリツケ,フルツクホーソ,コルレツヂ,クリスタベル,ロベリヤ,シツポク,ニユーメン,ウンドン,ナハ,ゲイモ,ギゾ,エブコ,ギスゴ,ホゴ,シヤコ,シラサ,カガシラ,ハイガシラ,フカシイモ,ムキミ,トシヨリコイ,ツパ,ヲハリ,ツヅク,グロキシア,ヅヅク,シゲヤマ,ラビツト,ジョルジ,ヨツク,フウフェランド,ドノル,レローイ,バチグノール,レクルース,クリチー,ビヽエン,リセリウ,ラシウル,ロイドレ,カシミル,ゴヲドシル,ゴルチァコフ,ヴィーコンスフィールド,アンバセエドル,パァリアメント,デクレレーション,ジカル,ジカル・ライフ,ケーシヨン,スフ,ンクス,ヤラザモリ,イクサモイ,ヱゾ,ヂヤナモイ,オヤミカマ,ツンマーシヤー,ワズ,ジャンボー,アテシコ,カラララン,カカラアン,スパルテホルツ,プ,ナクシヤトラ,セインス,ブルバーセンゼルマン,イアヌ,トナリ,カムイシユ,シュータプ,オタシュー,リフンライ,アンチピリ,タコイ,ピクメイン,オケアノス,ヴォヌム,トンチンカモイ,トイチ,インフルヱンザ,シヤギリ,ヅーフラ,ズウフラ,ヒプノヂズム,イルレデンタ,バアバア,タア,シオル,ウンコー,オシッコー,ヱヘン,ヘチ,ザツト,カチヤ,ガタツク,ソクイ,ヂレ,スハヤ,ネカラ,アツヱツ,イヤサ,シヤ,ソゲ,イヽサ,チヤク,トコセイ,ソイ,パテン,ブベシ,ヲナスコトモ,ニサヘモ,スルコトナシト,アレドモ,ユレバ,セザルコト,カナリト,サミユーエル,ベーカル,ミシコトモ,ヘラク,ベドモ,セザルガ,アンタマン,ジタル,スルニハ,バザルコト,コレアルガ,スルコト,ハザルニ,スベカラザルノ,セザルヲ,シキニハ,ラザルベシ,フレバ,ミザル,アルニ,ルマデ,ラザルハナシ,ルナシ,リシハ,ムルハ,コーペルニクス,デカールト,バザル,ゼズ,フベカラズ,トスレバ,トセザルヲ,トナスコト,クンバ,ハシムルニ,スルダモ,アレバ,ムルコト,タルノミ,スナク,タルコトヲ,レザルノ,メムト,スベキヤト,ギズ,ウスルナリ,ハズトモ,カニシ,クナラザレバ,ラクハ,ウスルニテ,ナルタケ,ハラズトモ,ルベキナリ,ムルガ,クスノミナラズ,メタキ,ウスルトハ,クナレドモ,スベキナリ,ザルハ,トスベキ,ユレドモ,ラズト,タリシニハ,リタル,キタル,ンゼザル,シタレ,ケタルモアリ,ケタレバ,カルベシト,ラザルヲ,ヘムヤ,ノコッタ,トテトンツツトン,オヒャラー,オヒャ,ヒヒャ,オヒャラアイ,ヒュウヤ,ヒョウルイヒ,ヒュウイ,チャンランチャンラン,ニャーフウー,テンプラクイタイ,マビ,ヒツスセリング,ハコムト,ハサルノ,セムコトヲ,メッド,オムメヤ,アバァス,アグニス,コンフォタブル,イスリントン,ヴィンチ,ヴィクトリヤ,ピトロクリ,スポーラン,キリクランキー,シェレー,ワルト・ホイットマン,ウェールス,ブリチッシ・ミュージアム,シュミッド,ダウデン,カア,キバタン,アティカ,ピュローン,セクストゥス・エムピリクス,セクストゥス,ニィーッチエ,ンショナル,ジャスティファイヤブル,チユウ,サルヴァトル・ロザ,ウォーヅウォース,ドウジ,ドージ,ミケルアンゼロ,ラフハエル,ツウチャン,イクジ,ニューオルリーンズ,ペーテルス,ダンバー,チャールス・ウェスレー,マータース,イケマセン,アッチ,ヤサシイ,クベ,マウント・ホリヨーク・セミナリー,ウェレスレー,ホリヨーク・セミナリー,セントスレバ,サレンヲ,セザレバ,ムル,シキカ,カレザルカ,ザレバ,ハザル,シカラザレバ,ダシクバ,レガ,グワラリ,コロコニ,トイチクル,チクチ,リウゴ,テラデルフユウゴ,ホクチ,ニラジイランド,ヴェネジュラ,オビラシベツ,オンネシヨサンベツ,セチリ,ピラカプト,ピラトリ,カイカウン,バトイチセコッコロカモイ,クッロポックグル,クッヲロ,ベリゴード,ニウジヤアシイ,コピアポ,イースタアアイランド,イシツツイ,カハラケ,ワッハヽヽヽ,イコジ,ヒストリアンスヒストリー,ロクゾー,セルヴァンテス,ビフテイキ,ズウ,シスレエ,ゴオガン,ルノアア,フオゲラア,ウヰスラア,テエムス・セツト,リアリスチツク,バルツ,イオリヤ,チャチャチャッチキチッチドンドン,チャチャチャッチキチッチ,コヤコヤ,チャチャチャッチキチッチッ,チャンカラチャンカラ,エルダアブラザア,マザア,ポクポクポクポク,トラヤアヤアヤアヤア,プラトニックラヴ,ナマリブシ,スイッチョ,テバナ,フアストラヴ,サアクル,カンガルウ,ラッケット,セリシア,イタリヤンストロウ,ホウル・クルーゲル,トオゴー,キヤブン,ケシムルモノハ,シムニ,ラザルモノ,タラザルヲ,セシムルニ,ルナリ,セザルノ,ナランヤ,ヰツト,ポイントマン,ゲダンケ,ロセチ,ルバイヤット,ヤムシイド,カイコバアド,カイコスル,ルスツム,ハチム,マアムウド,オマアカイアム,ブレエク,オオソリチイ,ケエツブロウ,ルキザンブル,ユウゴオ,ネオロマンチズム,タナグラ,ストウブ,ヱチケツト,コニヤツク,マドレーン,ガルビアニ,ヴイオロン,シユマン,ユウモレスク,フオオト,ユウゴウ,テイブルクロオス,ブウルワアル,ジエヱムス,トラヂシヨン,チヤアム,サンジエルマン,ヴエルサイユ,ヒネクレ,シユロラン,キミガヨラン,マワシ,サンシユユ,トベラノキ,キンギンボク,ハヒビヤクシン,シラガミススキ,ユヅリハ,フレツシ,ビヨルンソン,ソルバツケン,マーチャン,ジャランジャランジャラン,シヱークスピーア,ヘッヘヘヘヘヘ,セシヨリ,グルモ,ハシクシテ,ラザラントスルナリ,ラズンバアラズ,セシメシ,セシメタルモ,メシメタルモ,ノモノハ,ムヲ,ムルヲ,カザルトハ,チヨコント,ソーット,ポツチヤリ,ピヨイー,ネイー,ラッヴレイ,ウエバー,ヴァルキイル,ブランギン,ミルクセーク,ロングフェロオ,ケラモス,シドニイ,シェレエ,カシネ,ガブレル,ファタリテー,ヴェヌス,クレッサンド,モデラト,フランシスカ,ブーロンユ,カイゼルウィルヘルム,ホホホホ,ネホホホ,ヘヘヘヘ,ヲツトマカセ,バダバダ,チャーレス,ピヨトル,イヴァンペトロヴィッチ,フィッツゼラルド,トコツグ,トコナミ,トコナベ,ツカグロ,トトキ,トウド,ヴオルガ,アレクサンダア,パウル・ミルヨウコフ,ナンノッテ,アクサンチュエエ,ファキイル,アルラア・アルラア,フォマ・ゴルジエフ,フォマ,マリショオ,デモニック,アネクドオト,スタチスト,オリイブ,テンテンカラ,テンテンツツテンテンテン,ヴィルトシャフトリッヘ,アインハイト,オダテ,ホーマア,グウーッ,ラヂューム,アヴェスタ,ギッヂングス,ソシアス,ゾット,ホムンキルス,ショウトクオウガキミニセカレテ,カエリコンズカエリコントハオモエドモ,サダメナキヨニサダメナケレバ,ウノノド,アキナイタカラブネ,フクハキタリメデタヤ,デクル,マツテ,イロハニホ,ハニホ,ロハニ,ヘトハチリ,トハチ,ドロボツクル,ピヨイ,キバマガ,ゼシュイット,プロバビリテー,ユニバーシチー,フアーマー,ツルカケ,ヌルイ,ヨク,フケトリ,シツケ,ドレフュース,チウチウチウ,チュンチュンチュン,チュクチュクチュク,モオオオオ,モオオモオ,モオモオモオ,レキレキレキ,カラコロコロ,ピーヒョロリ,トウトウタラリ,ポポンポン,ヘヾライ,オチンボサマ,スウヰントン,ジュセッポ・ルッサナ,ジュセッポ,ヒッパーカス,ニューファウンドランド,コーデーション,チヨロリ,モネー,アレシキ,ダビドカ,シムソン,グリゴリー・ペトニコフ,オヴァオール,ケルソン,シヤリテエ,ハルトマン・ミヌス・,ハイカラア,ヱネチア,コイスチヨーワガナワ,コヒステフワガナハ,フォイト,コンシステンシイ,フラソコ,アウガスチン,イバン・ゼ・フール,ダイトクモツコ,モツコ,カグラサン,ヲダ,ナラエ,ヒヤラヒヤア,チツツン,チンツン,チュリップ,ボロオヂン,ボーロリボーロリ,シヤブ,パインナップル,オブストロブスキイ,ストルム,ビーヤホール,ヒステレー,ブルタル,ヒステレック,ウエーファ,ザク,ボオドイン,ガデブツシユ,フユヒテ,バアゼル,プッジング,エンゲージド,セゼッション,コントラジクション・イン・タームス,トマトー,ジャアジャア,オイチニ,ナァニ,エイヤエイヤ,ズボンボ,ドドンコ,マゴツキ,ツクネン,グビリグビリ,クロスカンツリーレース,アバラス,アーランニヤ,マハーブハラタ,クヽ,コスル,ヌシルヴアン,パンチヤタントラ,ダムナグ,ダマナカ,ヴイドヤーパチー,ビドバー,ビドパイ,ヘブリユ,アラビヤンナイト,バクダット,ラフオンテーン,パンチヤダントラ,ヨザフアート,シルラー,スツアルト,メガヅータ,リユツケルト,ヘロトタス,アカクアリユム,アクエアス,グノスチチスムス,シヨペンハワー,ヂユペロン,アルハベツト,アウム,カバラー,ヘブリユー,タリユース,スキラツキス,ヘロドタス,ストラボ,マカロニー,ヴォラプチュアス,オルノーコ,サザーン,ラッブ,ダーターファブラ,カリカチュアー,クールベエ,ヴェリテ,シャバンヌ,ハイドリオタフヒア,アドリエーナス,ピエルロチー,マガイ,シキシマ,キシネフ,トラホオム,ケレオソオト,プラットホオム,ヰクトリア,ゲエロック,ステッチン,モハビット,キンパラ,タテタテコンポ,ニムレテ,ケルハタテタテノ,チンノレイヤ,リシヲダマキノ,ツフサ,ラヌゲンゲンノ,ラシキ,ガクレシチンノレヤノ,ゴルキ,モモンガー,マイデヤサー,エンチヤンテレス,アトラントサウルス,イクチオサウルス,プレシオサウルス,ヂノテリウム,マケロヅス,シヤミセンガイ,パラボラ,ユニク,デッチョー,コムラ,オルトラマリン,タケー,メガネー,コシイ,バアントシーナ,メンパ,ゾッキ,ッピー,ボコ,チョイトコサ,ボウルド,トンダ,スヰントン,トヤ,ブコトハ,タルコト,タルヲ,キモノハ,フマヽヲ,カフコトモ,スルヲ,ナキモノナリ,ナゲナル,カラヌ,ルヲモ,キコトニテ,ブノミニ,メナレバ,スルコトニテ,ブハ,ジカラザレバ,クガ,ハシケレバ,レザルヲ,キヲノミ,カヽラヌ,キコトナリ,ナゾガ,ルモノハ,シトス,キモノニテ,セザルコトナラント,ルマジト,リシコトナレド,スルコトハ,キシテヨリ,レサヘ,ラヌ,ニナリシハ,シタルナリト,ノミニテモ,ラレヌ,マヽニテ,メズハ,クバカリ,タルヤト,トニテ,ニテ,レド,ジモノナリ,キコトニ,ラネド,キコトナラズヤ,ヒシコトナレド,マヌトテモ,キモノナラネバ,ラルヽニ,ニスルハ,カナルコトニコソ,ベントリロキズム,ウンニヤ,ポルトセエド,ステレオチイプ,パリイ,エエリヒ・シュミット,フリイドリヒ・ヘッベル,アドルフ・ハルナック,ハルナック,テオドジウス,グレシア,パンジオナアト,ボオレ,プロジット・ノイヤアル,ストララウ,スプレエ,スウィッツル,アントロポゲニイ,セゾン,ロア,ホオフナル,サンチマンタル,メルシイ,ゼリゼェ,テアアトル・フランセェ,ジムナアズ・ドラマチック,ジイ・フィロゾフィイ・デス・アルス・オップ,アルス・オップ,プラグマチスム,ヒポテジス,ファナチスム,ニョ,タウコギ,スグカエレ,ヒロイツク,ガチガチコツコツ,シドミ,トンカタントン,ボスニャ・ヘルチェゴビナ,ヂロ,キヤツキヤツ,スモオレツト,フイヽルヂング,サツカレエ,シエクスピイヤ,ゴツトシヤル,ゼネラリチイ,インヂヰヂユアリチイ,ハツクスレエ,ダルヰニスムス,インスピラチオン,マアチ,ジヨルジ・エリオツト,ドオデエ,ホオマア,マアロオ,ヲオヅヲオス,ヘエゲル,キルヒマン,フイツシエル,モオルトン,アリストテレエス,ユスチニヤン,ブウウ,ガリワル,リリピユウシヤン,スヰフト,リヤア,ミケランジエロ,ライプニツツ,ロオギツシエ,シヤフツベリイ,リイド,アプゾルウテ,ツルゲニエフ,パルメニデエス,プロチヌス,ヰクトル・クザン,スペクラチオン,プリンチピウム,インヂヰヅアチオヽニス,カルヽ・ロオベルト・エヅワルト・フオン・ハルトマン,ジユリエツト,スピノツア,インヂヰヅエルレ,ポオプ,ルクレツツ,エピクウル,エワレツト,プラトオ,プレヂカアト,リテラツウル,ウンド,ネプチユウン,ミレンニヤム,ポオザ,シヤスレル,スカンヂナヰヤ,エチユウド,ノスタルジヤ,ツルゲエネフ,プラタヌ,ミニウト,ウヰーク,チユウスデー,ヱンスデー,サアスデー,ジヤニユアリー,ヘブリユアリー,ヱプリル,ジユン,ジユライ,ヲクトヲバー,ヂセンバー,ワッペウ,ワッピョーワッピョー,オメグラ,ヤマニンジン,ヒメカンゾウ,コウリンカ,ヒキヨモギ,メドハギ,イヌハギ,ネコハギ,マキエハギ,アリノトウグサ,タチフウロソウ,グンナイフウロソウ,ハナナヅナ,コバノイチヤクソウ,フシグロセンノウ,トリアシショウマ,ムシャリンドウ,サワギキョウ,サラシナショウマ,イブキトラノオ,エンビセンノウ,マツムシソウ,マツバニンジン,ニガクサ,ウメバチソウ,コトジソウ,リュウノウギク,ヤマゴボウ,アブラガヤ,アシクラ,シモツケソウ,クカイソウ,ルリトラノオ,ウスユキソウ,ヨブスマソウ,ノブキ,キオン,コタヌキモ,ミツバオウレン,ツルコケモモ,イワゼキショウ,ショウジョウバカマ,ヤチスギラン,イヂメ,タカジヤスターゼ,アンドレア・デル・サルト,ニコラス・ニックルベー,セオファーノ,チリリリリン,シチュ,トチメンボー,メンチボー,ケニルウォース,モンセン,バリー・ペーン,ジヤスターゼ,タークイン・ゼ・プラウド,メジョオ・ペンデニス,マグネ,ノッズル,テレマカス,ペネロピー,ユーミアス,リーシャス,ブラクストーン,ピヤース・プローマン,ツ・ゼラルド,スッポコポンノポン,アイソクラチス,ソフォクリス,シモニジス,アハハハハハ,ヒヤヤヤ,ソクラチス,ツァイシング,ワハハハハハサヴェジ・チー,サヴェジ・チー,シャーレマン,オリムパス,クリーサス,ブルヌチェル,ミチリミチリ,オタンチン・パレオロガス,パレオロガス,ヴァルカン,セクスピヤ,ベランメー,トイフェルスドレック,ボー・ナッシ,アキリス,ヘクトー,クリシッパス,ベトヴェン,ゴシゴシゴシ,サンドラ・ベロニ,ンガー・ボール,チェヴィ・チェーズ,ダイオジニス,デモスセニス,マーカス・オーレリアス,プロータス,ヴァレリアス,カーテル・ムル,スピロヘーテ,パルリダ,フアゾムレス,クルソオ,ロビンソン・クルソオ,ビザンチニスム,シヨオヰニスム,セルヰリスム,マルチン・ルテル,レガル,ガタクリ,ベルネ,ヴヮイオリン,ウワータールー,グラッブ・ストリート,ヂレスリー,ヂッケンス,チープ・リテレチュア,レハイズ,リテレチュア,モウパスサン,コントラバーシー,バッチング,スンマツスツジウスツバンツスズキヨスキツ,デグニチー,バルブ・ブリウ,ウーヴ,ルチュール,グリイグ,ロマンチズム,ポプラー,ウォラビュック,ザメンコフ,ポストニコフ,エスペランチスト,シェークスピヤ,シンキーウ,モナドロギイ,シニツク,トラカル,グツシヨリ,カリホルニャ,サーキュレーチング,ベアトリチエ,プロメシウス,マクダ,ドストイエフスキー,ボツカシオ,スニハ,ルコトヲ,シタルトキ,セラレタルトキ,ケタル,セラレ,ヘサル,ケタルトキ,ヘタルトキ,ナラサルトキ,アリタルトキ,ウタレ,シヤンヨウ,ヂロツト,ムツゴロ,ワラスボ,メクワジヤ,アゲマキ,ウオタアヒアシンス,エチケツト,ゲザ,パツチパツチ,エロル,メロデア,ペパミント,フオク,フランチエスカ,キネオラマ,クロウバ,ジブシイ,フアンタジヤ,ヂキタリス,ヂヤツク,エメロウド,ガツグガツグ,ガメノシユブタ,シンフオニー,シムフオニイ,ホンニサイバ,ヨイヨオイ,タケガラス,サストリー,バンキポール,ダクバンガロー,マッチセン,ミスベサント,オルゴット,ネチーブ,アキレハツル,モゴルシュライ,イスマイリア,バルレー,イルクレー,ボールトン・アベー,プツデング,アイリッシュ・シチュー,ロンドンデリー,ポエット,カーナーボン,ランベリス,ウィリアム・コンクェロール,ツウオターロー,ウィッテンベルク,ツウィングリ,ストラスペッフェル,ベンウィビス,ベンネビス,コネー,レーニア,ミドローシァン,アルバノ,ロッカディパパ,ベルリイナア,タイフン,タケラモ・ニトベ,タケラモ,モーヴェ・パー,タヴァン,シャモニ,ゼネヴ,ストラスブルク,デュラー,エナ,タンネンバウム,ヴェネディヒ,シュエスター,ワイナハト,ワイナハトマン,エーベルフェルド,バウム,ワイナハトバウム,ジルヴェスターアーベンド,プンシュ,ミンナ・フォン・バルンヘルム,ノイヤール,プロージット・ノイヤール,デフレッガア,ブールバール・デジタリアン,オテルドヴィーユ,プール・レ・ポーヴル,アンジュルジャンス,ベデカ,ヴェスーヴ,コンフェッチ,キュイラシェ,マドムアゼル,ゲノア,ドガー,ピユリタン,ステンシヨ,カウカサス,ドラヴヰタス,ネグリトス,ハイペルボレアン,ヘヴリウ,フヰニシヤ,アリヤン,ヘブルウ'
'nonsense'	'ノンセンス,ナンセンス'
'norden'	'ノルデン'
'norman'	'ノルマン'
'north'	'ノース'
'note'	'ノート,ノオト'
'notebook'	'ノートブツク,ノオトブック'
'nous'	'ヌース'
'nunzio'	'ヌンチオ'
'nurnberg'	'ニュルンベルク'
'o''connell'	'オコンネル'
'o''day'	'オディ'
'oasis'	'オアシス'
'oatmeal'	'オートミール'
'obelisk'	'オベリスク'
'oboe'	'オボイ'
'octavo'	'オクタボ'
'oden'	'オーヂン,オーディン'
'odessa'	'オデッサ'
'ofili'	'オフィリ'
'ohm'	'オーム'
'olive'	'オリーヴ,オリーブ'
'oliver'	'オリヴァー,オリバー'
'omelet'	'オムレツ'
'onnes'	'オンネス'
'opera'	'オペラ'
'optimist'	'オプチミスト'
'orang'	'オラン'
'orange'	'オレンジ,オレンヂ'
'orchestra'	'オーケストラ'
'oregon'	'オレゴン'
'orgao'	'オルガン'
'original'	'オリジナル'
'orion'	'オライオン'
'orokko'	'オロッコ'
'orpheus'	'オルフォイス'
'oscar'	'オスカー'
'ounce'	'オンス'
'ouranos'	'ウラノス'
'out'	'アウト'
'outlook'	'アウトルツク'
'oxford'	'オックスフォード,オツクスフオード'
'ozone'	'オゾン'
'pace'	'パーチェ'
'pack'	'パック'
'package'	'パケ'
'painstaking'	'ペインステーキング'
'pal'	'パール'
'palace'	'パレス'
'palermo'	'パレルモ'
'palestina'	'パレスチナ'
'pali'	'パーリ'
'pall'	'ポール'
'pallas'	'パラス'
'pallet'	'パレツト,パレット'
'pamir'	'パミール'
'pan（汎）'	'パン'
'panama'	'パナマ'
'pannier'	'パニエ'
'panorama'	'パノラマ'
'paolo'	'パオロ'
'pap'	'パップ'
'par'	'パー'
'para'	'パラ'
'paracelsus'	'パラセルサス'
'paradise'	'パラダイス'
'paradox'	'パラドックス'
'parallax'	'パララックス'
'paranoia'	'パラノイア'
'parasol'	'パラソル'
'pardo'	'パルド'
'parlor'	'パーラー'
'parr'	'パー'
'pascal'	'パスカル'
'pass'	'パス'
'pastel'	'パステル'
'pater'	'パアテル'
'pathetic'	'パセティック'
'paton'	'ペイトン'
'paulos'	'パウロ'
'pause'	'ポーズ'
'pawn'	'ポーン'
'pay'	'ペイ'
'paz'	'パス'
'pea'	'ピイ'
'pearl'	'パール'
'pearly'	'パーリー'
'pedantry'	'ペダントリー'
'peel'	'ピール'
'pek'	'ペンキ'
'pekoe'	'ペコ'
'pelican'	'ペリガン'
'peloponnesos'	'ペロポネソス'
'pence'	'ペンス'
'pencil'	'ペンシル'
'penguin'	'ペンギン'
'peque'	'ペケ'
'percent'	'プロセント'
'percy'	'パーシー'
'petal'	'ペタル'
'peter'	'ピーター,ピータア'
'petros'	'ペテロ'
'philadelphia'	'フィラデルフィア'
'philemon'	'フィレモン'
'phoenicia'	'フェニキア'
'phon'	'ホン'
'phuntsholing'	'プンツォリン'
'pianist'	'ピアニスト'
'picnic'	'ピクニック'
'pie'	'パイ'
'pierrot'	'ピエロー'
'pigeon'	'ピジョン'
'pill'	'ピル'
'pinakothek'	'ピナコテエク,ピナコテーク'
'pineapple'	'パインアツプル,パインアップル'
'pinta'	'ピン'
'pipe'	'パイプ'
'pisa'	'ピサ'
'pitcher'	'ピッチャー'
'plan'	'プラン'
'platform'	'プラットフォーム,プラツトフオーム,プラツトホーム,プラットホーム'
'platonic'	'プラトニック'
'platoon'	'プラトーン'
'platt'	'プラット'
'platz'	'プラッツ'
'play'	'プレー'
'plot'	'プロツト'
'plum'	'プラム'
'plus'	'プラス'
'plusch'	'プリュッシュ'
'plymouth'	'プリマス'
'po'	'ポー'
'pocket'	'ポッケット,ポケット,ポツケツト,ポケツト'
'poet'	'ポエト'
'poker'	'ポーカー'
'pokhara'	'ポカラ'
'police'	'ポリス'
'politic'	'ポリチック,ポリチツク'
'polo'	'ポーロ,ポロ'
'pompeius'	'ポンペイウス'
'pompon'	'ポンポン'
'pool'	'プール'
'poplar'	'ポプラ'
'popular'	'ポピュラー'
'porridge'	'ポリッジ'
'porter'	'ポーター'
'porto'	'ポルト'
'portsmouth'	'ポウツマス,ポーツマウス,ポーツマス'
'positive'	'ポジチーブ'
'post'	'ポスト'
'potage'	'ポタージュ'
'potassic'	'ポトアシク'
'potato'	'ポテト'
'power'	'パワー'
'pragmatism'	'プラグマティズム'
'pragmatist'	'プラグマティスト'
'prelude'	'プレリュード'
'premium'	'プレミア'
'pretoria'	'プレトリア'
'preussen'	'プロイセン'
'pride'	'プライド'
'prince'	'プリンス'
'principle'	'プリンシプル'
'prism'	'プリズム'
'program'	'プログラム'
'prop'	'コロップ'
'prosit'	'プロージット'
'proud'	'プラウド'
'providence'	'プロビデンス'
'psycho'	'サイコ'
'psychological'	'サイコロジカル'
'pteranodon'	'プテラノドン'
'pudding'	'プディング'
'pull'	'プル'
'pulse'	'プルス'
'punch'	'ポンチ'
'puritan'	'ピューリタン'
'puritanism'	'ピユリタニズム'
'purse'	'パース'
'pushing'	'プッシング'
'pushkin'	'プーシキン'
'putt'	'パット'
'pym'	'ピム'
'pyramid'	'ピラミッド,ピラミツド,ピラミド'
'pythagoras'	'ピタゴラス,ピサゴラス'
'qatar'	'カタール'
'qazan'	'カザン'
'qom'	'クム'
'quart'	'コート'
'quebec'	'ケベック'
'queensland'	'クインスランド'
'queenstown'	'クイーンズタウン'
'quito'	'キト'
'racket'	'ラケット'
'radicalism'	'ラジカリズム'
'radium'	'ラジウム'
'raffaello'	'ラファエロ'
'rahman'	'ラーマン'
'rail'	'レール'
'raji'	'ラジ'
'rake'	'レーキ'
'rand'	'ランド'
'randle'	'ランドル'
'raskolnikov'	'ラスコーリニコフ'
'rat'	'ラット'
'ray'	'レイ'
'raymon'	'レイモン'
'reach'	'リーチ'
'reaction'	'リアクション'
'reader'	'リーダー,リードル'
'ready'	'レディ'
'real'	'リアル,レアル'
'rear'	'リヤ,リア'
'recardo'	'リカルド'
'recognize'	'レコグナイズ'
'record'	'レコード'
'red'	'レツド'
'redon'	'ルドン'
'regeneration'	'レゼネレイシヨン'
'rembrandt'	'レンブラント'
'renan'	'ルナン'
'rendell'	'レンデル'
'reno'	'リノ'
'republic'	'リパブリック'
'rest'	'レスト'
'restaurant'	'レストラン'
'revival'	'リバイバル'
'reye'	'ライ'
'rhetoric'	'レトリック'
'rheumatism'	'レウマチス,リューマチ,リュウマチ,リウマチ,リウマチス'
'rhododendron'	'ロードデンドロン'
'rhythm'	'リズム'
'rhythmical'	'リズミカル'
'ribbon'	'リボン'
'rice'	'ライス'
'richardson'	'リチャルドソン,リチャードソン'
'rico'	'リコ'
'rifle'	'ライフル'
'rimbaud'	'ランボオ'
'ring'	'リング'
'rio'	'リオ'
'rip'	'リップ'
'ris'	'リ'
'river'	'リバー'
'riyal'	'リヤル'
'roast'	'ロース'
'robert'	'ロバート'
'robinson'	'ロビンソン'
'roches'	'ロセツ'
'rochester'	'ロチェスター'
'rock（岩）'	'ロック,ロツク'
'rocking'	'ロッキング'
'rococo'	'ロココ'
'rohan'	'ロアン'
'rohm'	'レーム'
'role'	'ロール'
'roll'	'ロール'
'romance'	'ローマンス,ロマンス'
'romancer'	'ローマンサー'
'romanov'	'ロマノフ'
'romulus'	'ロムルス'
'ronis'	'ロニ'
'room'	'ルーム'
'roosevelt'	'ルーズベルト,ローズベルト,ルーズヴェルト'
'rosamond'	'ロザモンド'
'rose'	'ローズ'
'rosenthal'	'ローゼンタール'
'rothschild'	'ロスチャイルド'
'rotman'	'ロットマン'
'rotterdam'	'ロッテルダム'
'rouble'	'ルーブル'
'round'	'ランド'
'roux'	'ルー,ルウ'
'royal'	'ローヤル'
'rubens'	'ルウベンス'
'rubicon'	'ルビコン'
'rubidium'	'ルビヂオム'
'ruby'	'ルビ,ルビー'
'rue'	'リュ'
'rufus'	'ルーファス'
'rumania'	'ルーマニア'
'rumba'	'ルンバ'
'rupee'	'ルピー'
'rush'	'ラッシュ'
'russell'	'ラッセル'
'ruth'	'ルス,ルツ'
'rutherford'	'ラザフォード'
'ryle'	'ライル'
'sabah'	'サバ'
'sabel'	'サーベル,サアベル'
'saccharin'	'サッカリン,サツカリン'
'sack'	'サツク,サック'
'sage'	'セージ'
'sahara'	'サハラ'
'saigon'	'セイゴン'
'saine'	'セイヌ,セーヌ,セエヌ'
'sainte'	'サント'
'sakha'	'サハ'
'salad'	'サラダ,サラド'
'salado'	'サラド'
'salary'	'サラ'
'sale'	'セール'
'salizyl'	'サリチル'
'salmasi'	'サルマシ'
'salon'	'サロン,サルン'
'saloon'	'サルーン'
'sam'	'サム'
'samo'	'シャモ'
'samoa'	'サモア'
'sample'	'サンプル'
'sander'	'サンダー'
'sandwich'	'サンドウィッチ,サンドヰツチ,サンドウヰツチ,サンドイッチ'
'santos'	'サントス'
'sapa'	'サパ'
'sappho'	'サッフォー'
'saracen'	'サラセン'
'sarah'	'サラ'
'saratov'	'サラトフ'
'sardegna'	'サルディニア'
'satan'	'サタン'
'saturday'	'サタデー'
'sauce'	'ソース'
'saul'	'ソール'
'saxon'	'サクソン'
'scandinavia'	'スカンジナーヴ,スカンヂナビヤ,スカンジナビア'
'scarlet'	'スカレット'
'schlegel'	'シュレーゲル'
'schleiermacher'	'シュライエルマッヘル'
'schleswig'	'シュレスウィヒ'
'schmitt'	'シュミット'
'schon'	'シャン'
'science'	'サイヤンス,サイエンス'
'scipio'	'スキピオ'
'scoop'	'スクープ'
'scott'	'スコット,スコツト'
'scrap'	'スクラップ'
'screen'	'スクリーン'
'scythe'	'サイズ'
'season'	'シーズン'
'seattle'	'シヤトル,シアトル'
'sec'	'セック'
'second'	'セコンド,セカンド'
'sedan'	'セダン'
'seeley'	'シーリー'
'seeshaupt'	'ゼエスハウプト'
'selene'	'セレーネ'
'self'	'セルフ'
'sem'	'セム'
'semen'	'セメン'
'semi'	'セミ'
'send'	'センド'
'senegal'	'セネガル'
'sense'	'センス'
'sentiment'	'センチメント'
'sentimentalism'	'センチメンタリズム'
'separator'	'セパレータ'
'sepia'	'セピア'
'september'	'セプテンバー'
'sera'	'セラ'
'serbia'	'セルビア'
'seth'	'セス'
'sevastopol'	'セバストポール'
'sewing machine'	'ミシン'
'shade'	'シェード'
'shaft'	'シャフト'
'shah'	'シャー'
'shakespeare'	'シヱーキスピーア,シェイクスピア,シヱクスピーア,シェクスピア,シヱクスピヤ,シェクスピヤ,シェークスピア,シェーキスピーア,シェーキスピア,シエエクスピア,セークスピヤ'
'shaving'	'シェーヴィング'
'shawl'	'ショール'
'sheet'	'シーツ,シート,シイツ'
'shell'	'セル'
'shelley'	'シヱレイ'
'shilling'	'シリング,シルリング'
'shimrra'	'シムラ'
'ship'	'シップ'
'shock'	'シヨツク'
'shot'	'ショット'
'show'	'ショー,ショウ'
'shutter'	'シャッター'
'shy'	'シャイ'
'siebold'	'シーボルト'
'siegfried'	'ジーグフリード'
'siemens'	'シーメンス'
'sikh'	'シク'
'sikkim'	'シッキム'
'silhouette'	'シルウェット'
'silk'	'シルク'
'sima'	'シマ'
'simo'	'シモ'
'simplon'	'シンプロン'
'singer'	'ジンゲル'
'siphon'	'サイホン,サイフォン'
'siren'	'サイレン'
'sister'	'シスタア,シスター'
'sketch'	'スケッチ,スケツチ'
'sketchbook'	'スケッチブック'
'ski'	'スキー'
'skirt'	'スカート'
'slav'	'スラーブ,スラブ,スラヴ'
'sleep'	'スリープ'
'slipper'	'スリッパ'
'smiles'	'スマイルス'
'smith'	'スミス'
'snap'	'スナップ'
'snatch'	'スナッチ'
'snow'	'スノー'
'sofa'	'ソファ,ソフア,ソファー'
'soil'	'ソイル'
'sol'	'ソル'
'solar'	'ソーラ'
'sole'	'ソレ'
'solo'	'ソロ'
'solomon'	'ソロモン'
'solon'	'ソロン'
'soma'	'ソーマ'
'somali'	'ソマリ'
'sonata'	'ソナタ'
'sotto'	'ソット'
'soup'	'スープ,ソップ,スウプ,ソツプ'
'sousa'	'ソウサ'
'sowa'	'ソワ'
'spa'	'スパ'
'spade'	'スペード'
'spell'	'スペル'
'spelling'	'スペルリング'
'spenser'	'スペンサー,スペンセル'
'spinoza'	'スピノザ,スピノーザ'
'spiral'	'スパイラル'
'spirit'	'スピリット'
'spiritualism'	'スピリチュアリズム'
'spoil'	'スポイル'
'spoon'	'スプーン'
'stability'	'スタビリチー'
'stain'	'ステン'
'stained'	'ステンド'
'stan'	'スタン'
'standard'	'スタンダード'
'stanley'	'スタンレー'
'star'	'スター'
'stark'	'スタルク'
'start'	'スタート'
'statistic'	'スタチスチク'
'steam'	'スチーム,スティーム'
'step'	'ステップ'
'stern'	'スターン'
'stevenson'	'スチーヴンソン'
'stew'	'シチュウ,スチュー'
'stock'	'ストック'
'stockholm'	'ストックホルム'
'stoic'	'ストイック'
'stop'	'ストップ'
'storage'	'ストレージ'
'store'	'ストア'
'storm'	'ストーム'
'stout'	'スタウト'
'stove'	'ストーブ,ストーヴ'
'straw'	'ストロウ'
'studio'	'スチュディオ'
'study'	'スタディ'
'style'	'スタイル'
'sublime'	'サブライム'
'substance'	'サブスタンス'
'sudan'	'スーダン'
'sudra'	'スードラ'
'sugar'	'シュガー'
'sui'	'スイ'
'suit'	'スーツ'
'sulfate'	'ソルフェート'
'sum'	'スム,サム'
'sumatra'	'スマトラ,スマタラ'
'supper'	'サパー'
'sweden'	'スウェーデン,スウエーデン'
'swift'	'スウィフト,スウイフト'
'swinburne'	'スウィンバーン'
'syllable'	'シラブル'
'symbolism'	'シンボリズム'
'symmetry'	'シンメトリー'
'symonds'	'シモンズ'
'symphony'	'シンフォニー'
'taboo'	'タブー'
'tabula'	'タブラ'
'tacoma'	'タコマ'
'tafel'	'ターフル'
'tailor'	'テーラー'
'taker'	'テーカー'
'talanton'	'タラント'
'talking'	'トーキング'
'talmud '	'タルムード'
'talmy'	'タルミ'
'tamas'	'タマス'
'tambo'	'タンボ'
'tambourine'	'タンバリン'
'tanga'	'タンガー'
'tank'	'タンク'
'tantalus'	'タンタロス'
'tar'	'タール'
'tarlant'	'タルラン'
'taste'	'テースト'
'tate'	'テート'
'tatha'	'タター'
'taylor'	'テーラー'
'teff'	'テフ'
'telegraph'	'テレグラフ'
'telepathy'	'テレパシー'
'temple'	'テンプル'
'tempo'	'テンポ'
'temps'	'タン'
'tennis'	'テニス'
'tension'	'テンシヨン'
'terebinth '	'テレビン,テレピン'
'tern'	'ターン'
'terra'	'テラ'
'terrorist'	'テロリスト'
'teuton'	'チュートン'
'texas'	'テキサス'
'thackeray'	'サツカレー,サッカレー'
'thailand'	'タイ'
'thales'	'ターレス'
'thallium'	'タリウム'
'thames'	'テムズ'
'thank you'	'サンキュー'
'thant'	'タント'
'theatre'	'テアトル'
'thelma'	'テルマ'
'theme'	'テーマ'
'theodolite'	'セオドライト'
'theory'	'セオリー'
'thermal'	'サーマル'
'thom'	'トム'
'thomas'	'トーマス,トメ,トマス'
'thomson'	'トムソン'
'thorvaldsens'	'トーヴァルセン'
'thuringen'	'チューリンゲン'
'tic'	'チック,チツク'
'ticktack'	'チクタク'
'tiger'	'タイガー'
'tigris'	'チグリス'
'timothy'	'テモ'
'title'	'タイトル'
'toe'	'トゥ,トー'
'tolba'	'トルバ'
'tomato'	'トマト'
'tomo'	'トモ'
'tone'	'トーン'
'tongue'	'タン'
'tonus'	'トーヌス'
'tool'	'ツール'
'top'	'トップ'
'topia'	'トピア'
'torr'	'トル'
'torrent'	'トリエント'
'toscana'	'トスカナ'
'totemism'	'トーテミズム'
'tour'	'ツア'
'towel'	'タオル'
'trachoma'	'トラホーム'
'trafalgar'	'トラファルガー'
'tragedy'	'トラゼヂー,トラヂヱヂイ'
'trail'	'トレール'
'tray'	'トレイ,トレー'
'tree'	'ツリ'
'tremolo'	'トレモロ'
'tristram'	'トリストラム'
'triton'	'トライトン'
'troy'	'トロイ,トロヤ'
'truck'	'トロコ,トロッコ'
'trump'	'トランプ'
'trunk'	'トランク'
'trypsin'	'トリプシン'
'tsar'	'ツァー,ツァーリ'
'tub'	'タブ'
'tuberkulin'	'ツベルクリン'
'tunis'	'チュニス'
'turban'	'ターバン'
'turbine'	'タービン'
'turgenev'	'ツルゲーネフ,ツルゲネエフ,ツルゲネーフ'
'turgot'	'チュルゴー'
'turkestan'	'トルキスタン'
'turner'	'ターナー'
'turning'	'ターニング'
'tweed'	'トウィード'
'tyndale'	'チンダル'
'typewriter'	'タイプライター'
'typist'	'タイピスト'
'tyrol'	'チロル'
'underline'	'アンダーライン'
'upanishad'	'ウパニシヤツド'
'ural'	'ウラル'
'utah'	'ユタ'
'utopia'	'ユートピア,ユートピヤ'
'vakzin'	'ワクチン'
'val'	'ヴァル,バル'
'valley'	'バレー'
'van'	'ワン,ヴアン,ファン'
'vancouver'	'バンクーバー'
'varnish'	'ニス,ワニス'
'vatican'	'バチカン'
'vault'	'ボールト'
'veau'	'ヴォー'
'venezia'	'ヴェネチア'
'venezuela'	'ベネズエラ'
'venice'	'ヴェニス,ベニス'
'veranda'	'ヴェランダ,ベランダ'
'verbeck'	'フルベツキ'
'verse'	'バース'
'vettel'	'ベッテル'
'via'	'ビーア,ヴィア'
'vibrio'	'ビブリオ'
'vice'	'バイス'
'vicomte'	'ヴィコント'
'vidro'	'ビードロ'
'view'	'ビュウ'
'vill'	'ヴィル'
'vin'	'ヴァン'
'violin'	'バイオリン,ヴァイオリン,ヴアイオリン'
'virchow'	'ウィルヒョウ'
'virgil'	'ヴァージル'
'virgin'	'ヴァジン'
'vis'	'ビス'
'vital'	'ビタル'
'vitte'	'ウヰツテ'
'vladimir'	'ウラジーミル'
'vlag'	'フラフ'
'vodka'	'ウォッカ'
'volga'	'ヴォルガ'
'volt'	'ボルト'
'volunteer'	'ボランティア'
'vote'	'ボーツ'
'vought'	'ボート'
'wade'	'ウェード'
'waist'	'ウェスト'
'waldo'	'ワルド'
'wall'	'ウオール'
'waltz'	'ワルツ'
'ward'	'ウォード'
'warren'	'ワーレン'
'warszawa'	'ワルソウ'
'water'	'ウォーター'
'waterloo'	'ワーテルロー,ウォータールー'
'watson'	'ワトソン'
'watt'	'ワット,ワツト'
'way'	'ウエー,ウェー'
'webster'	'ウェブスター,ウエブストル,ヱブスター'
'weimar'	'ワイマル,ワイマール'
'wellington'	'ウェリントン,ウエリントン,ウエリングトン,エルリントン'
'werner'	'ベルナー'
'westminster'	'ウェストミンスター'
'weston'	'ウェストン'
'whitman'	'ホイットマン'
'wild'	'ワイルド'
'wilde'	'ワイルド'
'win'	'ウィン'
'winkle'	'ウィンクル'
'wisconsin'	'ウイスコンシン'
'wit'	'ウィット'
'witch'	'ウィッチ'
'wolf'	'ウォルフ'
'wordsworth'	'ウオーヅオルス,ウォーズウォース,ワーズワース'
'yacht'	'ヨット'
'yak'	'ヤク'
'yakutsk'	'ヤクーツク'
'yankee'	'ヤンキー'
'yarn'	'ヤン'
'yaw'	'ヨー'
'yes'	'イエス'
'yoke'	'ヨーク'
'yorkshire'	'ヨークシャー'
'yucatan'	'ユカタン'
'zaal'	'ザール'
'zeno'	'ゼノ'
'zero'	'ゼロ'
'zeus'	'ゼウス'
'zoo'	'ズー'
'zorro'	'ゾロ'
'zurich'	'チューリヒ'
