ａ	Ａ
ａｂ	ＡＢ
abba	Abba
abbe	ABBe
abbey	Abbey
abc	abc,ABC
ａｂｃ	ＡＢＣ
ａｂｃｄ	ＡＢＣＤ
abend	Abend
aber	Aber
above	above
abu	Abu
abul	Abul
ac	ac
acade	acade
accidents	Accidents
actif	actif
acting	Acting
actress	actress
adieu	adieu
adler	Adler
admirable	admirable
admirari	admirari
adventure	adventure
adventuress	adventuress
affair	Affair
affect	affect
affectionate	affectionate
affiche	affiche
afrique	Afrique
after	after
against	against
agnodice	Agnodice
agressif	agressif
ah	Ah
ai	Ai
aim	Aim
air	air
aiyan	AIYAN
akimbo	akimbo
akin	akin
alceste	Alceste
alge	Alge
aliud	aliud
alphonse	Alphonse
als	als
alterthu	Alterthu
altruismus	Altruismus
altrustique	altrustique
always	always
ａｍ	ＡＭ
amazed	amazed
amentia	AMENTIA
amicitiae	amicitiae
an	an,An
anchor	anchor
ancient	Ancient
andan	andan
andronicus	Andronicus
anfang	Anfang
animal	Animal
animoque	animoque
annales	Annales
annihilation	Annihilation
annunzio	Annunzio
anomalous	anomalous
another	another
answer	answer
anteregan	ANTEREGAN
anticipation	Anticipation
antige	Antige
antipathisch	antipathisch
antipathy	antipathy
antisociale	antisociale
aozora	aozora
ap	ap
apathique	apathique
aphorismen	Aphorismen
appear	appear
arbiter	arbiter
archai	Archai
archbishop	Archbishop
archipelago	Archipelago
archiv	Archiv
archive	Archive
archives	Archives
are	are
aristokratie	Aristokratie
arm	Arm
armagh	Armagh
armenian	Armenian
armer	armer
arrested	Arrested
arrie	arrie
arts	arts
as	as
asiatische	Asiatische
assault	assault
astacidae	Astacidae
astley	Astley
at	at
ata	Ata
atavisme	Atavisme
atavismen	Atavismen
ati	Ati
atlas	Atlas
atque	Atque
atropos	Atropos
attracted	attracted
attraction	Attraction
attribute	attribute
au	Au,au
auberge	auberge
auch	auch
auche	auche
aude	Aude
auguste	Auguste
augustinus	Augustinus
aulieh	Aulieh
aum	AUM
aurelius	Aurelius
aus	aus
auszu	Auszu
authoritaeten	Authoritaeten
authorities	Authorities
automne	Automne
autonomie	Autonomie
autosuggestion	autosuggestion
aventure	aventure
avez	Avez
awakened	awakened
away	away
b	B,b
ｂ	Ｂ
baden	Baden
bae	Bae
baelz	Baelz
baghdad	Baghdad
baiser	BAISER,Baiser
ballet	ballet
bambyce	Bambyce
bambycina	Bambycina
band	band
bangor	Bangor
banko	BANKO
banlieue	Banlieue
basse	BASSE,Basse
bath	Bath
batten	BATTEN,batten
bazaillas	Bazaillas
bdres	bdres
beal	Beal
beaucoup	beaucoup
beaudelaire	Beaudelaire
beaute	BEAUTE
before	before
begleiten	Begleiten
behind	Behind,behind
beiname	Beiname
bel	bel
ben	Ben
benjo	Benjo
berezin	Berezin
berhaupt	berhaupt
bernstein	Bernstein
berufsmaessig	berufsmaessig
besitzen	besitzen
bessbrook	Bessbrook
bethesda	Bethesda
bettelheim	Bettelheim
better	better
between	between
beweggrund	Beweggrund
beziehenden	Beziehenden
bezieht	bezieht
bhadra	Bhadra
bien	bien
biron	Biron
bitte	Bitte
bitume	bitume
bius	bius
bless	bless
bleu	bleu
bliss	bliss,Bliss
blue	blue,Blue
boccaccio	Boccaccio
boggy	boggy
bohe	Bohe
bonum	Bonum,bonum
borgia	Borgia
borkmann	Borkmann
bosheit	Bosheit
boudoir	boudoir
bourn	bourn
bow	bow
braid	Braid
brain	Brain
branch	Branch
brand	Brand
branler	branler
bray	Bray
bre	Bre
breath	breath
breathing	breathing
breeze	breeze
bretojo	Bretojo
brille	brille
briss	BRISS
broomhall	Broomhall
brother	brother
brouillard	brouillard
bru	Bru
brumsen	Brumsen
brunetie	Brunetie
buche	Buche
bucher	Bucher
bugle	bugle
but	But,but
c	C,c
ｃ	Ｃ
cabanel	Cabanel
cadence	cadence
cafin	Cafin
caliphate	Caliphate
calme	calme
campbell	Campbell
camper	Camper
can	can
canon	Canon,canon
canorus	CANORUS
capito	Capito
cardinal	Cardinal
caress	caress
carlisle	Carlisle
carnarvon	Carnarvon
carnaval	Carnaval
carneval	Carneval
cartas	Cartas
casanova	Casanova
casiri	Casiri
castagnette	CASTAGNETTE
casuistik	Casuistik
casus	casus,Casus
catching	Catching
catholic	Catholic
causeway	Causeway
cavalleria	Cavalleria
ce	ce,Ce
censure	censure
centaurea	Centaurea
centimes	Centimes
cercle	cercle
cesare	Cesare
ch	ch
chaleureuse	chaleureuse
chambre	chambre
changement	changement
chants	Chants
chaos	chaos
charite	Charite
charmin	Charmin
charpentier	Charpentier
charta	Charta
chavannes	Chavannes
cher	Cher
cherchez	Cherchez
cherlich	cherlich
chiao	chiao
china	China
chine	Chine
chloral	Chloral
cho	cho
choses	choses
chronological	Chronological
churchwarden	Churchwarden
ci	Ci
citato	citato
cite	cite
civilization	Civilization
cke	cke
clartes	clartes
claude	Claude
clausewitz	Clausewitz
cle	cle
clergy	Clergy
cliente	Cliente
clifford	Clifford
clique	Clique,clique
cloche	cloche
clock	clock
clothed	clothed
clouds	clouds
cnaudes	Cnaudes
co	co
code	Code
coe	Coe
coeternal	coeternal
coeur	Coeur
cold	cold
collection	collection
collegium	Collegium
collision	collision
colonna	Colonna
colonnade	colonnade
colours	Colours
come	Come
comedia	comedia
comme	comme
compania	Compania
comparationis	comparationis
complain	Complain
complot	complot
composed	Composed
conditionale	conditionale
conformist	Conformist
connaissance	connaissance,Connaissance
considered	Considered
consolation	Consolation
contemplatif	contemplatif
contra	contra
contrat	Contrat
contre	contre
converge	Converge
copulationstrieb	Copulationstrieb
coq	Coq
coquettish	coquettish
cormi	cormi
corot	Corot
corps	Corps,corps
cos	cos
country	country
coup	coup,Coup
courager	courager
course	course
courte	courte
cox	Cox
crane	Crane
cre	cre,Cre
creature	creature
creeping	Creeping
criture	criture
crowing	crowing
cucu	CUCU
cuculus	CUCULUS
curare	Curare
curate	Curate
curiosa	Curiosa
curse	Curse
cxv	cxv
cxvi	cxvi
cynic	cynic,Cynic
cynisme	Cynisme
cynismus	Cynismus
cyr	Cyr
d	D,d
ｄ	Ｄ
da	da
dahin	dahin
dakbungalow	Dakbungalow
dalgas	Dalgas
damascus	Damascus
dame	Dame
danaide	Danaide
danishmand	Danishmand
dans	dans
daudet	Daudet
days	days
de	de,De
deacon	Deacon
dead	dead
dean	Dean
death	death,Death
dedicate	dedicate
dehmel	Dehmel
dejection	dejection
delirium	delirium
dem	dem
demokratie	Demokratie
den	den
denovalin	Denovalin
denunciate	denunciate
der	der,Der
descends	descends
descent	descent
dessen	dessen
dessins	dessins
destin	destin
detached	detached
deux	Deux
deve	Deve
diable	diable
diabolic	diabolic
diagonal	diagonal
dialect	Dialect
diamant	diamant
dictionary	Dictionary
didaskalia	DIDASKALIA
dieses	dieses
dieux	dieux
dignite	dignite
diminutif	diminutif
din	Din
ding	Ding
diocese	Diocese
dionisos	Dionisos
dionysos	Dionysos
diplomatique	diplomatique
direction	direction
discret	discret
disease	Disease
disillusion	Disillusion
dissenter	Dissenter
divided	divided
divina	Divina
do	Do
doch	doch
documents	Documents
doer	Doer
doing	Doing
domestic	Domestic
domesticus	DOMESTICUS
dominante	dominante
domino	domino
done	done
doux	doux
down	down
dragon	dragon
dramatik	Dramatik
drang	Drang
draperie	draperie
dre	dre
dread	dread
dream	Dream
dreamt	dreamt
drear	drear
drowsy	drowsy
drue	drue
druerie	Druerie
drung	Drung
dsu	Dsu
du	du
dub	dub
durtal	Durtal
dynamismus	Dynamismus
dz	dz
e	e,E
ｅ	Ｅ
eastern	Eastern
eat	eat
echo	echo
eckstein	Eckstein
economics	Economics
edgar	Edgar
edition	Edition
edum	Edum
effe	effe
effet	effet
effrena	Effrena
eggs	eggs
egoismus	Egoismus
egoistique	egoistique
eh	eh
eier	Eier
ein	Ein
eindruck	Eindruck
einheit	Einheit
einmal	einmal
einsam	einsam
einsamkeit	Einsamkeit
einst	einst
ele	Ele
elegantiarum	elegantiarum
elegy	Elegy
elektra	Elektra
elements	Elements
elias	Elias
emeraude	Emeraude
emile	Emile
emir	Emir
emphatic	emphatic
en	en
encens	encens
encyclopedia	Encyclopedia
ende	Ende
endrum	Endrum
endum	Endum
energetik	Energetik
energie	Energie
english	English
enrico	Enrico
enrum	Enrum
entered	entered
enthousiasme	enthousiasme
entier	entier
entrez	Entrez
entru	Entru
envie	envie
ephthalites	Ephthalites
epictetus	Epictetus
epoche	Epoche
er	Er,er
erb	Erb
ere	ere
erfindung	Erfindung
erforschung	Erforschung
erkennbaren	erkennbaren
erscheinungen	Erscheinungen
erste	Erste
erum	Erum
erworben	ERWORBEN
erzherzog	Erzherzog
erziehung	Erziehung
esprit	Esprit,esprit
esquisses	esquisses
esse	Esse
est	est
et	et
etc	etc
eternal	Eternal
ethica	Ethica
ethologia	Ethologia
etre	Etre
etymologie	Etymologie
eugenics	Eugenics
europeans	Europeans
evangelical	Evangelical
even	even
everlastingly	everlastingly
every	every
everything	everything,Everything
evil	evil
exact	exact
excuse	excuse
existiert	existiert
exotic	Exotic
exoticomanie	Exoticomanie
exotiqeque	exotiqeque
exotisme	Exotisme
expe	expe
expectation	Expectation
f	F
ｆ	Ｆ
face	Face,face
factor	factor
faint	faint
fair	fair
fairy	Fairy
faite	Faite
faiyu	Faiyu
fall	fall
fanatic	fanatic
fantaisie	Fantaisie
fare	Fare
farewell	FAREWELL
fart	fart
fasquelle	Fasquelle
fataliste	fataliste
fatalistique	fatalistique
fatalistisch	fatalistisch
fate	Fate
faubourg	Faubourg
faule	faule
faune	Faune
fausset	fausset
fazl	Fazl
fe	fe
feel	feel
femme	femme
ferdinand	Ferdinand
fergha	Fergha
fernand	Fernand
feuilles	Feuilles
feuilleton	feuilleton
few	few
fibres	Fibres
fierte	fierte
fig	fig
figaro	Figaro
fine	Fine,fine
finissable	finissable
first	First,first
flaubert	Flaubert
fleetwood	Fleetwood
flegmatique	flegmatique
fleur	Fleur
flies	flies
flower	Flower
flowers	flowers
fois	fois
fontainebleau	Fontainebleau
food	food
forest	forest
formality	Formality
fornice	fornice
forschung	Forschung
forth	Forth
foudre	foudre
four	Four
foxterriers	Foxterriers
foyer	foyer
frail	frail
francs	Francs
fraught	fraught
french	French
freshing	freshing
freund	Freund
friars	Friars
friedhof	Friedhof
friendly	friendly
frigiditas	frigiditas
frivole	frivole
frivolus	Frivolus
from	from
fromentin	Fromentin
fu	fu
fuoco	Fuoco
furz	Furz
fut	fut
futable	futable
futile	futile
g	G
ｇ	Ｇ
gabriel	Gabriel
galite	galite
gallus	GALLUS
gambling	Gambling
ganzen	ganzen,Ganzen
garc	garc
garcia	Garcia
gardens	gardens
garnie	garnie
gautier	Gautier
ge	ge,Ge
gebar	gebar
geek	Geek
gegen	gegen
geht	geht
geiger	GEIGER
geil	Geil
gelehrten	Gelehrten
gemu	Gemu
gen	gen
genesis	Genesis
genoux	genoux
gentlemen	gentlemen
germain	Germain
germinal	Germinal
geschehen	Geschehen
geschichte	Geschichte
geschrift	Geschrift
geste	geste
ghad	ghad
ghaz	ghaz
giaque	giaque
giles	Giles
gill	Gill
gillard	Gillard
gin	gin,Gin
gives	gives
glad	glad
glaube	Glaube
gloria	gloria
gnedn	Gnedn
gobelins	gobelins
going	going
goiste	goiste
golden	golden
gone	gone
gonshan	Gonshan,GONSHAN
gonsyan	GONSYAN
gorjki	Gorjki
gottsched	Gottsched
gou	Gou
gr	gr
grand	grand
granil	Granil
grass	grass
grave	Grave
greco	Greco
grieg	Grieg
grimace	grimace
grondante	grondante
gronde	gronde
gru	Gru
gu	Gu
guten	guten,Guten
guys	Guys
gynt	Gynt
h	H,h
ｈ	Ｈ
ha	Ha
hachisch	Hachisch
had	had
hail	Hail
half	half
hallucination	hallucination
hamashima	Hamashima
hanako	Hanako
hanging	hanging
happy	happy
hardt	Hardt
hartmann	Hartmann
has	has
haschisch	Haschisch
hastings	Hastings
haukal	Haukal
havanna	Havanna
have	have
he	he
headed	headed
hearing	hearing
hearted	hearted
heaven	Heaven,heaven
heidelberg	Heidelberg
heimat	Heimat
heimweh	Heimweh
heinrich	Heinrich
heinsius	Heinsius
herder	HERDER
here	Here
heretical	heretical
hermaos	hermaos
herr	Herr
heute	heute
heyne	Heyne
heyse	Heyse
ｈｆｐ	ＨＦＰ
hiddscha	Hiddscha
hierophilus	Hierophilus
highland	Highland
higkeit	higkeit
hikomikoto	hikomikoto
himemikoto	himemikoto
hinter	hinter
hirth	Hirth
his	his
historian	Historian
hit	hit
ho	Ho
hoernle	Hoernle
hofmannsthal	Hofmannsthal
hohenzollern	Hohenzollern
hole	hole
holy	holy
holyhead	Holyhead
homosexuel	homosexuel
hope	hope
hopes	hopes
horatio	Horatio
host	host
howorth	Howorth
hrt	hrt
http	http
https	https
hu	hu
hudson	Hudson
hufeland	Hufeland
human	Human
huysmans	Huysmans
hydrocephalus	Hydrocephalus
hylozoischer	hylozoischer
hylozoismus	Hylozoismus
hyndman	Hyndman
hypnotize	hypnotize
hypocrites	hypocrites
i	I
ｉ	Ｉ
iapon	Iapon
ibn	ibn,Ibn
ideale	Ideale
idiosyncrasie	Idiosyncrasie
iesus	Iesus
ihn	ihn
ii	II
iii	III
ikuri	IKURI,Ikuri
il	il,Il
ille	ille
illustration	Illustration
im	Im
imitatio	IMITATIO
immensum	immensum
impels	Impels
imperativ	Imperativ
impotent	Impotent
impre	Impre
imsonisch	IMSONISCH
in	in,In
inarticule	inarticule
incense	incense
incertain	incertain
incumbent	Incumbent
inde	inde
indeed	indeed
indiffe	indiffe
indiscret	indiscret
individuell	individuell
inimica	inimica
innocente	innocente
inoctavo	inoctavo
inquiry	Inquiry
insolent	insolent
inspire	inspire
institut	Institut
inte	Inte
interessirt	interessirt
interjectional	INTERJECTIONAL
intime	intime
into	into
introduction	Introduction
inventor	Inventor
io	io
iomelesidonophrunicherata	iomelesidonophrunicherata
ironie	ironie
ironique	ironique
ironiquement	ironiquement
irradiation	Irradiation
irre	irre
ishaisme	ishaisme
islamische	Islamische
islamisme	Islamisme
isolde	Isolde
ist	ist
itinerarivm	itinerarivm
itself	Itself,itself
ivresse	Ivresse
iya	iya
ｊ	Ｊ
j	J
jacob	JACOB,Jacob
jahresberichte	Jahresberichte
jami	Jami
janu	Janu
janvier	janvier
jaques	Jaques
jaune	jaune
jesting	Jesting
jesus	Jesus
jet	jet
jhon	Jhon
joliie	JOLIIE
jouer	jouer
journal	Journal
journeying	journeying
joyful	joyful
jp	jp
juan	Juan
jugendschrift	Jugendschrift
juki	Juki
just	just
jutland	Jutland
juvenile	juvenile
ｋ	Ｋ
k	K
ka	Ka
kabru	Kabru
kaghaz	Kaghaz
kambodscha	Kambodscha
kanchenjunga	Kanchenjunga
karabacek	Karabacek
karlsruhe	Karlsruhe
karlstrasse	Karlstrasse
karluk	Karluk
kategorischer	Kategorischer
keine	keine,Keine
khanfou	Khanfou
khora	Khora
khosru	Khosru
khotan	Khotan
kimura	Kimura
kindling	kindling
kiue	Kiue
klar	klar
klimakterium	Klimakterium
knower	Knower
ko	ko,Ko
kok	Kok
kokila	KOKILA
kokkyx	KOKKYX
kolossos	kolossos
kommt	kommt
konstant	konstant
kosinski	Kosinski
krebs	Krebs
kritikus	Kritikus
kuchih	Kuchih
kuckuck	KUCKUCK
kukkuta	KUKKUTA
kutaiba	Kutaiba
kyon	kyon
l	L,l
ｌ	Ｌ
la	la,La
laboratorium	Laboratorium
labyrinth	Labyrinth
lacouperie	Lacouperie
laissez	Laissez
lamartine	Lamartine
lanberis	Lanberis
lands	Lands
lascivus	Lascivus
lassailly	Lassailly
lassie	lassie
last	last
latium	Latium
laugh	laugh
laughter	laughter
lautverschiebung	LAUTVERSCHIEBUNG
lax	lax
lazar	LAZAR
learn	learn
learning	learning
leben	leben
legende	LEGENDE
legge	Legge
lei	lei
leichtfertig	leichtfertig
leichtsinnig	Leichtsinnig
lemonnier	Lemonnier
lemur	lemur
lemures	lemures
leod	Leod
les	Les,les
lethe	Lethe
letters	Letters
lexicon	Lexicon
libi	libi
library	Library
lieb	lieb
lieben	lieben
liebeswerbung	Liebeswerbung
light	Light,light
lih	lih
lime	Lime
limination	limination
limit	Limit
linden	Linden
lipps	Lipps
lisa	Lisa
lisburn	Lisburn
lisme	lisme
literatur	Literatur
literature	literature
little	little
live	live
livius	Livius
lnische	lnische
loco	loco
lodie	lodie
logis	logis
logische	Logische
lois	lois
lombroso	Lombroso
londonderry	Londonderry
lone	lone
longer	longer
longing	Longing
longobardi	Longobardi
look	look
lordly	lordly
lore	lore
los	los
lost	lost,Lost
loti	Loti
louise	Louise
loupe	Loupe
lourdes	Lourdes
lucretius	Lucretius
lui	lui
luigi	Luigi
lunatics	lunatics
lupus	lupus
lus	LUS
lutheranism	Lutheranism
lyra	Lyra
m	m,M
ｍ	Ｍ
mac	Mac
macadam	Macadam
machen	machen
macht	macht
mademoiselle	Mademoiselle
maerchen	Maerchen
magazin	Magazin
mahagoni	Mahagoni
mahome	Mahome
mainlaender	Mainlaender
malheur	malheur
malintentionne	malintentionne
malum	Malum
manie	manie
manifestations	Manifestations
mankind	Mankind
manual	Manual
manuscrits	manuscrits
many	many
marcellus	Marcellus
marcus	Marcus
mardi	Mardi
mariage	Mariage
marie	Marie
maritime	Maritime
martyrs	Martyrs
mascagni	Mascagni
masochist	Masochist
masque	masque
massenet	Massenet
massif	massif
materie	Materie
mathisen	Mathisen
matique	matique
matteo	Matteo
maupin	Maupin
max	Max
me	me,Me
mean	mean
meditations	Meditations
mein	mein
meine	meine
membre	membre
memento	Memento
memi	memi
memoriam	Memoriam
men	Men,MEN
menai	Menai
mended	mended
mensch	Mensch
mente	mente
ments	ments
menu	Menu
mer	mer
merkmal	MERKMAL
merkwu	merkwu
merwa	Merwa
merz	Merz
mesmer	Mesmer
messagerie	Messagerie
messiah	Messiah
metamorphoses	Metamorphoses
method	Method
metschnikaff	Metschnikaff
metschnikoff	Metschnikoff
mid	mid
midi	Midi
midst	midst
miens	miens
might	Might,might
miles	miles
milieu	milieu
mimicry	Mimicry,mimicry
minds	minds
mine	mine
miniature	miniature
mique	mique
mirror	mirror
misanthrope	misanthrope
mise	Mise
misty	misty
miths	Miths
mitily	Mitily
mitteilungen	Mitteilungen
mittel	Mittel
mo	Mo,mo
mode	Mode
modele	modele
modification	Modification
mohammedans	Mohammedans
molie	Molie
mollendorf	Mollendorf
mon	mon
monastery	Monastery
monde	monde
mondes	Mondes
mongolei	Mongolei
monico	MONICO
monis	MONIS
monisch	monisch
monmartore	MONMARTORE
monna	Monna
moralische	Moralische
moralite	moralite
morbidezza	Morbidezza
morholm	Morholm
moritz	Moritz
mormon	Mormon
morois	Morois
mort	mort
mot	mot
motive	motive
mountain	mountain,Mountain
mountains	mountains
mouret	Mouret
mousser	mousser
movement	movement
moving	Moving
mr	Mr
ｍｓ	ＭＳ
mu	Mu
much	much
mueller	MUELLER,Mueller
mulier	mulier
multiple	Multiple
muori	muori
murder	Murder
murmur	Murmur
musagetes	Musagetes
muslim	Muslim
mylius	Mylius
mystique	Mystique
mystische	mystische
mytyl	Mytyl
n	n,N
ｎ	Ｎ
na	na
nachbild	Nachbild
nachworte	Nachworte
naif	Naif
naively	naively
nakiwarai	NAKIWARAI
napole	Napole
narr	Narr
narsissus	Narsissus
natur	Natur
naturalism	Naturalism
naturalisme	naturalisme
naturalismus	Naturalismus
navigatio	Navigatio
nchen	nchen
ne	ne
near	near
nebelmeer	Nebelmeer
neigung	Neigung
nement	nement
nen	nen
nenni	nenni
nervosite	nervosite
neugierde	Neugierde
nevis	Nevis
nherr	nherr
ni	ni
nicht	nicht,Nicht
nicolas	Nicolas
nihilismus	Nihilismus
nil	nil
niladmirali	niladmirali
nion	nion
nisi	nisi
nit	Nit
nitat	Nitat
noch	noch
non	Non,non
nonchalant	nonchalant
nor	nor
normal	normal
noskai	Noskai,NOSKAI
nostalgia	Nostalgia
not	not
notar	Notar
nothing	nothing
nothingness	Nothingness
notre	Notre
nouvelles	Nouvelles
now	now
ns	ns
nunnery	Nunnery
nushirvan	Nushirvan
nuttall	Nuttall
nwedel	nwedel
nymphe	Nymphe
o	o,O
ｏ	Ｏ
ob	ob
oberhaut	Oberhaut
obscure	Obscure
occident	Occident
occidentaux	Occidentaux
ocupe	ocupe
odan	Odan
oder	oder
oe	oe
off	off
offspring	offspring
ogilby	Ogilby
oh	Oh
ohne	ohne
ohsson	Ohsson
oiseau	oiseau
olenti	Olenti
om	OM
omika	OMIKA,Omika
omineuse	omineuse
ommeya	Ommeya
omne	omne
once	Once
ondine	Ondine
one	One,ONE,one
ongo	Ongo,ONGO
only	only
onomatopoeie	ONOMATOPOEIE
onomatopoetisch	ONOMATOPOETISCH
op	op
open	Open,open
operaglass	Operaglass
or	or,Or
orche	Orche
origin	Origin
originalite	Originalite
origine	Origine
orthographi	Orthographi
orthographie	Orthographie
orthos	orthos
oso	oso
ostend	Ostend
otype	otype
ou	Ou
oung	oung
our	Our
ouseley	Ouseley
over	over,Over
ovid	Ovid
owls	owls
p	P,p
ｐ	Ｐ
padres	padres
pah	PAH
pain	pain
pake	Pake
palladius	Palladius
palliatif	palliatif
palliativ	palliativ
pan	Pan
pana	Pana
pancatratar	Pancatratar
panthe	Panthe
papiers	Papiers
papiersin	Papiersin
papyrus	Papyrus
paquin	Paquin
parallaxe	Parallaxe
paralle	paralle
parchment	Parchment
parfum	parfum
parish	Parish
parle	parle
paroxysme	paroxysme
part	part
parthia	Parthia
parting	parting
pas	pas
passif	passif
past	Past,past
pasteur	Pasteur
pathognomisch	PATHOGNOMISCH
pathology	Pathology
pathos	Pathos
patria	patria
patriarch	Patriarch
patron	Patron
paulsen	Paulsen
pauthier	Pauthier
peacefulness	peacefulness
peer	Peer
peine	peine
pelliot	Pelliot
pemphigus	Pemphigus
pena	Pena
pense	pense
penseur	Penseur
peragravit	peragravit
perfect	perfect
persephone	Persephone
personality	Personality
persuasion	persuasion
perth	Perth
perverse	perverse
phe	Phe
philipp	Philipp
philopithecia	Philopithecia
philosophie	Philosophie
philosophy	philosophy,Philosophy
phisical	Phisical
phonetik	Phonetik
physical	Physical
physique	Physique
piaster	Piaster
piece	piece
pilgrim	Pilgrim
pine	pine
pisode	pisode
pissarro	Pissarro
pithecanthropus	Pithecanthropus
pity	Pity,pity
place	place
platonique	platonique
please	please
pleasure	pleasure,Pleasure
plein	plein
png	png
poche	poche
poi	poi
poignard	poignard
pointe	pointe
politikon	Politikon
polype	polype
poor	poor
poque	poque
pornographie	pornographie
portefeuille	portefeuille
portrush	Portrush
pose	pose,Pose
poseur	poseur
possession	Possession
possibilite	possibilite
pouvoir	pouvoir
poverty	Poverty
pp	pp
ｐｒ	ＰＲ
praxis	Praxis
ｐｒｂ	ＰＲＢ
precious	PRECIOUS,Precious
prehistoric	Prehistoric
prevailing	Prevailing
priest	Priest
printemps	Printemps
pro	pro
probabilite	probabilite
proble	proble
prodigieux	prodigieux
profanation	profanation
programm	Programm
progress	Progress
proportion	proportion
proposed	proposed
proske	Proske
prosper	Prosper
prostitution	prostitution
prote	prote
province	Province
prudery	Prudery
publikus	Publikus
pucific	Pucific
pudenda	pudenda
puissante	puissante
pupils	pupils
pure	pure,Pure
purgstall	Purgstall
pursue	pursue
puscule	puscule
puzzles	puzzles
qazwi	Qazwi
qu	qu
quagmire	quagmire
que	que
quel	Quel
qui	qui
quick	Quick
quid	Quid
quietive	Quietive
quracio	QURACIO
r	R,r
rable	rable
radloff	Radloff
raffermer	raffermer
raffine	raffine
rag	Rag
rainer	Rainer
raison	raison
rame	Rame
rament	rament
rarotonga	Rarotonga
rashi	Rashi
rashid	Rashid
rasi	Rasi
rather	rather
ratzel	Ratzel
raube	Raube
rauhen	rauhen
rayon	rayon
rdig	rdig
re	re
reached	reached
realism	Realism
ream	Ream
rector	Rector
redress	redress
refine	refine
reforms	Reforms
refrain	refrain
regrettant	regrettant
reinaud	Reinaud
reineke	Reineke
relation	Relation
reluctantly	reluctantly
renaudot	Renaudot
rendez	Rendez
rendre	rendre
rent	rent
repre	repre
res	res
resignation	Resignation,resignation
resma	Resma
resolbt	resolbt
ressant	ressant
returns	returns
reve	reve
revoir	revoir
revue	Revue
reynos	reynos
rezma	Rezma
rhetorik	Rhetorik
rhythme	Rhythme
ria	ria
ricci	Ricci
rich	rich
ridicule	ridicule
rienne	rienne
ries	Ries
rigoretto	Rigoretto
rime	rime
rimental	rimental
risma	Risma
risme	risme
rite	rite
roique	roique
romancier	Romancier
romantiker	Romantiker
romantique	romantique
rome	rome
rot	rot
rotique	rotique
rotten	Rotten
rough	rough
roughish	roughish
roughrider	roughrider
routine	routine
routiniers	routiniers
ruine	ruine
rumeur	rumeur
runique	runique
rusticana	Rusticana
rye	Rye
rythmes	RYTHMES
ｓ	Ｓ
s	S,s
sa	sa,Sa
saadi	Saadi
saalebl	Saalebl
sabbat	SABBAT
sacre	Sacre
sadder	Sadder
saddest	saddest
sadist	Sadist
sae	Sae
sahabi	Sahabi
said	Said
sails	sails
saison	saison
sakata	Sakata
salt	salt
salvarsan	Salvarsan
samain	Samain
sammlung	Sammlung
sario	sario
sataniste	sataniste
savage	Savage
savonarola	Savonarola
sayer	Sayer
sc	Sc
scandal	scandal
scared	scared
sce	sce
schaal	Schaal
schallnachahmung	SCHALLNACHAHMUNG
scham	Scham
schillerpreis	Schillerpreis
schluss	Schluss
schmidt	Schmidt
scho	scho,Scho
schrei	SCHREI
schwellenwert	Schwellenwert
scientific	Scientific
script	SCRIPT
se	se
sea	Sea,sea
seatle	Seatle
seaward	seaward
seconded	seconded
secular	Secular
see	see
seene	Seene
seigneur	Seigneur
sein	sein
seine	Seine
seiner	seiner
selbst	selbst
selkirk	Selkirk
sens	Sens
sensation	Sensation,sensation
sensible	sensible
sentative	sentative
sentimentalisme	sentimentalisme
serres	Serres
seul	seul
sexual	Sexual
sexualis	SEXUALIS
sexuology	Sexuology
shakespear	Shakespear
shalt	shalt
sharp	Sharp
she	She
shelter	shelter
shigis	Shigis
shine	Shine
ships	ships
shore	shore
shrill	shrill
shudder	Shudder
shutting	shutting
sich	Sich,sich
side	Side
sidesman	Sidesman
sie	sie
sight	Sight,sight
sign	Sign
signation	signation
signs	signs
sil	sil
silent	Silent
silentium	Silentium
silliguri	Silliguri
sillusion	sillusion
simia	Simia
simiae	simiae
simianitas	Simianitas
simmel	Simmel
simpleton	Simpleton
sincerest	sincerest
single	single
sinistres	sinistres
sisypos	Sisypos
sittlich	Sittlich
sittliche	sittliche,Sittliche
ske	Ske
skepticismus	Skepticismus
skunks	skunks
small	small
sme	sme
snowdon	Snowdon
social	social,Social
socialism	Socialism
socius	Socius
solely	solely
solennel	solennel
solitary	solitary
solitude	Solitude
soll	soll
some	some
something	something,Something
somnambuule	somnambuule
son	son,Son
sonate	Sonate
song	Song
songs	songs
sonia	Sonia
sono	Sono
sonus	SONUS
soothe	soothe
sori	SORI,Sori
soudain	soudain
sounds	sounds
south	South
species	Species
spermatophore	SPERMATOPHORE
sphere	sphere
spiritisme	Spiritisme
spiritismus	Spiritismus
spirits	Spirits
splendeur	Splendeur
sport	sport
sprachkunde	Sprachkunde
sprachschrei	SPRACHSCHREI
spring	spring
sse	sse
ssig	ssig
ｓｓｓ	ＳＳＳ
st	St
stairs	stairs
stand	stand
stanzas	Stanzas
ste	ste
steckt	steckt
steep	steep
steinthal	STEINTHAL
stelio	Stelio
sten	sten
stenfeld	stenfeld
stephan	Stephan
stereotype	stereotype
stil	Stil
still	still
stocking	Stocking
stra	stra
strange	Strange
strathpeffer	Strathpeffer
strauss	Strauss
stray	stray
streben	streben
streber	Streber
strindberg	Strindberg
string	string
stu	Stu
studies	studies
stuermerei	Stuermerei
stung	stung
sturm	Sturm
su	su
substanz	Substanz
sudden	Sudden
sudermann	Sudermann
suggestif	suggestif
suisang	Suisang
sujet	sujet
summer	Summer
summits	summits
summum	Summum
sun	Sun
sur	sur
surprise	surprise
swamp	swamp,Swamp
swaru	swaru
sweet	sweet
sweetest	sweetest
swiftly	swiftly
syme	syme
sympathisch	sympathisch
symphonique	symphonique
syoben	syoben
syphilisation	Syphilisation
t	T,t
ｔ	Ｔ
taa	Taa
tabaks	Tabaks
tabellen	Tabellen
tables	Tables
tai	tai
taifun	Taifun
taji	Taji
take	take
talent	Talent
tales	Tales
tame	tame
tantris	Tantris
taphysique	taphysique
tara	Tara
tashkend	Tashkend
tavote	Tavote
te	te
teddy	Teddy
tell	tell
tempe	tempe
tender	tender,Tender
ter	ter
terre	terre
terror	Terror
tersa	Tersa
tertium	tertium
testament	Testament
teufel	Teufel
tewarikh	Tewarikh
textile	Textile
thank	thank
thanks	Thanks
theatron	Theatron
thee	thee
their	Their,their
then	then
theodor	Theodor
theorie	THEORIE
there	there,There
therefore	Therefore
thiersant	Thiersant
things	things
thinks	thinks
thor	Thor
those	those
thou	Thou,thou
thought	thought
three	Three
thy	thy
thyself	thyself
tiberius	Tiberius
tiedemann	TIEDEMANN
tierschrei	TIERSCHREI
tigerhill	Tigerhill
tin	Tin
tinco	Tinco
tinka	Tinka,TINKA
tintern	Tintern
tisme	tisme
titanos	Titanos
ｔｋ	ＴＫ
tobaccos	Tobaccos
tolerance	Tolerance
tomam	Tomam
toman	Toman
tonjukuk	Tonjukuk
tonka	Tonka,TONKA
tonnerre	tonnerre
too	too
torride	torride
tostao	Tostao
tou	Tou
tourne	tourne
tout	tout,Tout
toutes	toutes
tower	Tower
tral	tral
trale	trale
transfigured	Transfigured
transgression	Transgression
traum	Traum
travaille	travaille
traveller	traveller
travellers	travellers
travels	Travels
tre	TRE,tre
treads	treads
trees	trees
trene	Trene
trieb	Trieb
triomphe	triomphe
trique	trique
tristan	Tristan
triumviri	triumviri
tru	Tru
true	True
truth	Truth
tsukiji	Tsukiji
ttlich	ttlich
tu	Tu
tuberculin	Tuberculin
twanging	twanging
twenty	Twenty
twixt	twixt
two	Two
tyltyl	Tyltyl
tyran	tyran
tyrant	TYRANT
tzen	tzen
tzlaff	tzlaff
u	u,U
ｕ	Ｕ
ud	ud
ueber	Ueber
uiliq	Uiliq
un	un,Un
unbefangen	unbefangen
unbewus	Unbewus
uncritically	uncritically
understanding	Understanding
understood	understood
undiscover	undiscover
une	UNE,une,Une
univers	univers
universal	Universal
unma	Unma
uns	uns
unter	Unter
upon	Upon
upu	upu
urine	Urine
urning	Urning
us	us
use	Use
ut	ut
utilitaire	utilitaire
v	V
ｖ	Ｖ
va	va
vagabondage	vagabondage
vaitipi	Vaitipi
vale	Vale
vallisneria	VALLISNERIA
vanite	vanite
varie	varie
varied	varied
various	Various
vase	Vase
ve	ve
vedi	Vedi
verbiest	Verbiest
verdant	verdant
verdi	Verdi
verger	Verger
vergleichungs	Vergleichungs
verhaeren	Verhaeren
vermo	Vermo
versteht	versteht
vesta	Vesta
vexation	vexation
vibrates	vibrates
vicar	Vicar
victor	Victor
vide	vide
vie	vie
vingt	Vingt
violon	Violon
virtue	Virtue
virtuoso	virtuoso
vischer	Vischer
vision	Vision
visiting	visiting
vissie	Vissie
vitality	Vitality
vittoria	Vittoria
vivra	vivra
voice	voice
voit	Voit
voix	Voix
vol	vol,Vol
voleur	voleur
volitio	Volitio
vorzeit	Vorzeit
vos	vos
vous	vous,Vous
voyages	Voyages
vraie	vraie
w	W
ｗ	Ｗ
wa	wa
waft	Waft
wahlfreiheit	Wahlfreiheit
wakka	Wakka
wanda	Wanda
want	want
war	war
warm	warm
was	Was,was
wasiwasi	Wasiwasi
watches	Watches
watteau	Watteau
wau	WAU
weigh	weigh
weinen	WEINEN
weininger	Weininger
weird	weird
weltgrund	Weltgrund
weltwille	Weltwille
wenn	wenn
wer	wer
were	were
wesen	Wesen
wet	wet
wetterleuchten	Wetterleuchten
wha	wha
when	when
where	Where,where
which	which
whistler	Whistler
whit	whit
whole	Whole
whoo	whoo
whose	whose
wiesner	Wiesner
wight	wight
wildenbruch	Wildenbruch
will	Will,will
willen	Willen
willingly	willingly
wilson	Wilson
wimmern	WIMMERN
winchelsea	Winchelsea
wind	wind
winds	winds
wings	wings
wir	wir
wirklichkeit	Wirklichkeit
wirtschaftliche	Wirtschaftliche
wish	wish
wissbegierde	Wissbegierde
wissen	wissen
with	with,With
wolff	Wolff
wolkenkratzer	Wolkenkratzer
wooded	wooded
worauf	worauf
work	work
world	World,world
would	would
wretched	wretched
written	written
wu	Wu
wundt	WUNDT
www	www
wyvis	Wyvis
ｘ	Ｘ
xanthis	Xanthis
ｘ線	Ｘ線
ｙ	Ｙ
y	y
yachi	Yachi
yea	Yea
years	years
yield	yield
yokaraka	YOKARAKA,Yokaraka
yoranbansho	YORANBANSHO
yoshino	Yoshino
your	Your,your
z	z,Z
ｚ	Ｚ
zeiss	Zeiss
zeitrechung	Zeitrechung
zeitung	Zeitung
zeugungsglied	Zeugungsglied
zieh	Zieh
ziya	Ziya
zo	Zo
zolla	Zolla
zu	zu,Zu
zuguterletzt	Zuguterletzt
zum	zum
zur	zur
zurechnungsfa	Zurechnungsfa
zweisam	zweisam
zwielicht	Zwielicht
